Region,Country,Year,Category,Brand,Tier 1,Tier 2,Tier 3,Pep (%),Budget (LC),Pep Budget (LC),Bottler Budget (LC),Budget,Pep Budget,Bottler Budget
LAB South,Brazil,2024,Sport Drinks,Gatorade,Pull-Non-Working,Ad Production,Digital Ad Production,50,3777026,1982700,1794326,701295,368135,333160
LAB South,Brazil,2024,Sport Drinks,Gatorade,Pull-Non-Working,Ad Production,Other Ad Production,50,3482925,1823673,1659252,646688,338608,308080
LAB South,Brazil,2024,Sport Drinks,Gatorade,Pull-Non-Working,Ad Production,TV Print Radio OOH Prod,50,321987,152998,168989,59784,28407,31377
LAB South,Brazil,2024,Sport Drinks,Gatorade,Pull-Non-Working,Agency Fees,Creative Agency Fees,50,3501881,1804609,1697272,650208,335069,315139
LAB South,Brazil,2024,Sport Drinks,Gatorade,Pull-Non-Working,Agency Fees,In Store and POS Design/Development,50,2787568,1396262,1391306,517579,259249,258330
LAB South,Brazil,2024,Sport Drinks,Gatorade,Pull-Non-Working,Agency Fees,Media Agency Fees,50,659949,319031,340918,122535,59235,63300
LAB South,Brazil,2024,Sport Drinks,Gatorade,Pull-Non-Working,Agency Fees,Other Agency Fees,50,7105467,3494308,3611159,1319300,648802,670498
LAB South,Brazil,2024,Sport Drinks,Gatorade,Pull-Non-Working,Agency Fees,Social Media/Influence Marketing,50,6915302,3454758,3460544,1283992,641458,642534
LAB South,Brazil,2024,Sport Drinks,Gatorade,Pull-Non-Working,Innovation and Insight,Innovation,50,1162757,587458,575299,215893,109075,106818
LAB South,Brazil,2024,Sport Drinks,Gatorade,Pull-Non-Working,Innovation and Insight,Market Research,50,416424,202415,214009,77319,37583,39736
LAB South,Brazil,2024,Sport Drinks,Gatorade,Pull-Non-Working,Innovation and Insight,Other Innovation and Insight,50,418993,210855,208138,77796,39150,38646
LAB South,Brazil,2024,Sport Drinks,Gatorade,Pull-Non-Working,Insight,Advanced Analytics,50,705550,363601,341949,131002,67511,63491
LAB South,Brazil,2024,Sport Drinks,Gatorade,Pull-Non-Working,Insight,Brand Building,50,737595,360016,377579,136952,66845,70107
LAB South,Brazil,2024,Sport Drinks,Gatorade,Pull-Non-Working,Insight,Consumer Tracking,50,22480407,11775087,10705320,4174028,2186328,1987700
LAB South,Brazil,2024,Sport Drinks,Gatorade,Pull-Non-Working,Insight,Customer / Retail and Insights and Analytics,50,5397298,2683947,2713351,1002138,498339,503799
LAB South,Brazil,2024,Sport Drinks,Gatorade,Pull-Non-Working,Insight,Foundational Data / Systems,50,864006,427373,436633,160423,79352,81071
LAB South,Brazil,2024,Sport Drinks,Gatorade,Pull-Non-Working,Insight,Innovation Insights,50,1192237,564202,628035,221367,104757,116610
LAB South,Brazil,2024,Sport Drinks,Gatorade,Pull-Non-Working,Insight,Strategic Insights,50,3377489,1706972,1670517,627112,316940,310172
LAB South,Brazil,2024,Sport Drinks,Gatorade,Pull-Non-Working,Other Non Working,All Other Non Working,50,1849475,936883,912592,343399,173954,169445
LAB South,Brazil,2024,Sport Drinks,Gatorade,Pull-Non-Working,Other Non Working,NW-Cross Charges,50,49969,26282,23687,9277,4879,4398
LAB South,Brazil,2024,Sport Drinks,Gatorade,Pull-Non-Working,Other Non Working,NW-Excluded non-A&M Items,50,306893,159859,147034,56982,29681,27301
LAB South,Brazil,2024,Sport Drinks,Gatorade,Pull-Non-Working,Other Non Working,NW-Fall In / Fall Out,50,1544251,755331,788920,286727,140245,146482
LAB South,Brazil,2024,Sport Drinks,Gatorade,Pull-Non-Working,Other Non Working,Out of Scope Countries ( D8 Gastos),50,15363054,7684886,7678168,2852520,1426883,1425637
LAB South,Brazil,2024,Sport Drinks,Gatorade,Pull-Non-Working,Package Design,Other Package Design,50,15351362,8019952,7331410,2850349,1489097,1361252
LAB South,Brazil,2024,Sport Drinks,Gatorade,Pull-Non-Working,Package Design,Package Design,50,33351680,16681655,16670025,6192541,3097350,3095191
LAB South,Brazil,2024,Sport Drinks,Gatorade,Pull-Working,Consumer Promotions,Consumer Promotions Execution,50,4406106,2218472,2187634,818099,411912,406187
LAB South,Brazil,2024,Sport Drinks,Gatorade,Pull-Working,Consumer Promotions,Coupons (Redemption),50,3428065,1777873,1650192,636502,330104,306398
LAB South,Brazil,2024,Sport Drinks,Gatorade,Pull-Working,Consumer Promotions,Other Consumer Promotions,50,8049009,4121845,3927164,1494492,765319,729173
LAB South,Brazil,2024,Sport Drinks,Gatorade,Pull-Working,Consumer Promotions,Premiums,50,226244,110759,115485,42007,20565,21442
LAB South,Brazil,2024,Sport Drinks,Gatorade,Pull-Working,In Store & POS Execution,In-Store and POS Execution,50,221443,110901,110542,41116,20591,20525
LAB South,Brazil,2024,Sport Drinks,Gatorade,Pull-Working,In Store & POS Execution,Other In-Store and POS Execution,50,3390709,1690810,1699899,629566,313939,315627
LAB South,Brazil,2024,Sport Drinks,Gatorade,Pull-Working,Media Placements,Digital Media,50,3307976,1723793,1584183,614205,320063,294142
LAB South,Brazil,2024,Sport Drinks,Gatorade,Pull-Working,Media Placements,Media Placements,50,14242391,7001471,7240920,2644442,1299991,1344451
LAB South,Brazil,2024,Sport Drinks,Gatorade,Pull-Working,Media Placements,Other Media,50,13569810,7109241,6460569,2519561,1320001,1199560
LAB South,Brazil,2024,Sport Drinks,Gatorade,Pull-Working,Other Working,All Other Working,50,8076976,4052099,4024877,1499684,752369,747315
LAB South,Brazil,2024,Sport Drinks,Gatorade,Pull-Working,Other Working,W-Cross Charges,50,8063762,3816925,4246837,1497231,708703,788528
LAB South,Brazil,2024,Sport Drinks,Gatorade,Pull-Working,Other Working,W-Excluded non-A&M Items,50,24709312,11630552,13078760,4587878,2159491,2428387
LAB South,Brazil,2024,Sport Drinks,Gatorade,Pull-Working,Other Working,W-Fall In / Fall Out,50,4372819,2177131,2195688,811919,404236,407683
LAB South,Brazil,2024,Sport Drinks,Gatorade,Pull-Working,Sampling,Other Sampling,50,53679,27624,26055,9966,5129,4837
LAB South,Brazil,2024,Sport Drinks,Gatorade,Pull-Working,Sampling,Product Samples,50,665131,349985,315146,123497,64983,58514
LAB South,Brazil,2024,Sport Drinks,Gatorade,Pull-Working,Sampling,Sample Executing,50,16712303,8228655,8483648,3103041,1527847,1575194
LAB South,Brazil,2024,Sport Drinks,Gatorade,Pull-Working,Sponsorships,Other Sponsorships,50,21461659,10986728,10474931,3984873,2039950,1944923
LAB South,Brazil,2024,Sport Drinks,Gatorade,Pull-Working,Sponsorships,Sponsorships,50,2056623,994757,1061866,381861,184700,197161
LAB South,Brazil,2024,Sport Drinks,Gatorade,STB - Push,Capability Building/Other,Capability Building,50,1254877,643607,611270,232998,119501,113497
LAB South,Brazil,2024,Sport Drinks,Gatorade,STB - Push,Capability Building/Other,Capability Building/Other-Other,50,2038789,1086205,952584,378550,201680,176870
LAB South,Brazil,2024,Sport Drinks,Gatorade,STB - Push,Trade Equipment,On Premise Equipment,50,32977278,17313331,15663947,6123024,3214636,2908388
LAB South,Brazil,2024,Sport Drinks,Gatorade,STB - Push,Trade Equipment,"Stands/ Racks, Other Trade Equipment",50,17701545,8965871,8735674,3286717,1664729,1621988
LAB South,Brazil,2024,Sport Drinks,Gatorade,STB - Push,Trade Equipment,Trade Equipment-Other,50,6925335,3431306,3494029,1285855,637104,648751
LAB South,Brazil,2024,Sport Drinks,Gatorade,STB - Push,Trade Programs,Distribution Incentives,50,1704942,862246,842696,316563,160096,156467
LAB South,Brazil,2024,Sport Drinks,Gatorade,STB - Push,Trade Programs,Innovation Investments,50,2768192,1384218,1383974,513981,257013,256968
LAB South,Brazil,2024,Sport Drinks,Gatorade,STB - Push,Trade Programs,Other Trade Programs,50,29261355,14423700,14837655,5433074,2678106,2754968
LAB South,Brazil,2024,Sport Drinks,Gatorade,STB - Push,Trade Programs,Sales Incentives,50,4722692,2350836,2371856,876881,436489,440392
LAB South,Brazil,2024,Sport Drinks,Gatorade,STB - Push,Trade Programs,Space Investments,50,4662253,2447917,2214336,865659,454514,411145
LAB South,Brazil,2024,Sport Drinks,Gatorade,STB - Push,Unilateral,CDAs,50,3162136,1582729,1579407,587126,293871,293255
LAB South,Brazil,2024,Sport Drinks,Gatorade,STB - Push,Unilateral,Capital Equipment,0,0,0,0,0,0,0
LAB South,Brazil,2024,Sport Drinks,Gatorade,STB - Push,Unilateral,Other Unilateral,50,1098928,528050,570878,204042,98045,105997
LAB South,Brazil,2024,Sport Drinks,Gatorade,STB - Push,Unilateral,Price Support,50,1726959,842782,884177,320651,156482,164169
LAB South,Brazil,2024,CSD,H2OH,Pull-Non-Working,Ad Production,Digital Ad Production,50,4026586,1949958,2076628,747632,362056,385576
LAB South,Brazil,2024,CSD,H2OH,Pull-Non-Working,Ad Production,Other Ad Production,50,3650314,1788463,1861851,677768,332071,345697
LAB South,Brazil,2024,CSD,H2OH,Pull-Non-Working,Ad Production,TV Print Radio OOH Prod,50,318868,154243,164625,59205,28638,30567
LAB South,Brazil,2024,CSD,H2OH,Pull-Non-Working,Agency Fees,Creative Agency Fees,50,3584809,1793304,1791505,665606,332970,332636
LAB South,Brazil,2024,CSD,H2OH,Pull-Non-Working,Agency Fees,In Store and POS Design/Development,50,2911692,1391295,1520397,540625,258327,282298
LAB South,Brazil,2024,CSD,H2OH,Pull-Non-Working,Agency Fees,Media Agency Fees,50,645834,315906,329928,119914,58655,61259
LAB South,Brazil,2024,CSD,H2OH,Pull-Non-Working,Agency Fees,Other Agency Fees,50,6923435,3561436,3361999,1285502,661266,624236
LAB South,Brazil,2024,CSD,H2OH,Pull-Non-Working,Agency Fees,Social Media/Influence Marketing,50,7245318,3560129,3685189,1345267,661023,684244
LAB South,Brazil,2024,CSD,H2OH,Pull-Non-Working,Innovation and Insight,Innovation,50,1125165,578863,546302,208913,107479,101434
LAB South,Brazil,2024,CSD,H2OH,Pull-Non-Working,Innovation and Insight,Market Research,50,415285,212090,203195,77107,39379,37728
LAB South,Brazil,2024,CSD,H2OH,Pull-Non-Working,Innovation and Insight,Other Innovation and Insight,50,415010,207031,207979,77056,38440,38616
LAB South,Brazil,2024,CSD,H2OH,Pull-Non-Working,Insight,Advanced Analytics,50,740005,366771,373234,137399,68099,69300
LAB South,Brazil,2024,CSD,H2OH,Pull-Non-Working,Insight,Brand Building,50,728929,366456,362473,135343,68041,67302
LAB South,Brazil,2024,CSD,H2OH,Pull-Non-Working,Insight,Consumer Tracking,50,23494053,11264177,12229876,4362236,2091465,2270771
LAB South,Brazil,2024,CSD,H2OH,Pull-Non-Working,Insight,Customer / Retail and Insights and Analytics,50,5174492,2584223,2590269,960768,479823,480945
LAB South,Brazil,2024,CSD,H2OH,Pull-Non-Working,Insight,Foundational Data / Systems,50,854349,436067,418282,158630,80966,77664
LAB South,Brazil,2024,CSD,H2OH,Pull-Non-Working,Insight,Innovation Insights,50,1144183,597776,546407,212445,110991,101454
LAB South,Brazil,2024,CSD,H2OH,Pull-Non-Working,Insight,Strategic Insights,50,3408006,1604676,1803330,632778,297946,334832
LAB South,Brazil,2024,CSD,H2OH,Pull-Non-Working,Other Non Working,All Other Non Working,50,1851553,930298,921255,343785,172732,171053
LAB South,Brazil,2024,CSD,H2OH,Pull-Non-Working,Other Non Working,NW-Cross Charges,50,51938,25079,26859,9643,4656,4987
LAB South,Brazil,2024,CSD,H2OH,Pull-Non-Working,Other Non Working,NW-Excluded non-A&M Items,50,302743,159087,143656,56211,29538,26673
LAB South,Brazil,2024,CSD,H2OH,Pull-Non-Working,Other Non Working,NW-Fall In / Fall Out,50,1567895,767921,799974,291117,142583,148534
LAB South,Brazil,2024,CSD,H2OH,Pull-Non-Working,Other Non Working,Out of Scope Countries ( D8 Gastos),50,16064310,8056157,8008153,2982725,1495819,1486906
LAB South,Brazil,2024,CSD,H2OH,Pull-Non-Working,Package Design,Other Package Design,50,15958250,7588678,8369572,2963033,1409020,1554013
LAB South,Brazil,2024,CSD,H2OH,Pull-Non-Working,Package Design,Package Design,50,32395027,17010493,15384534,6014916,3158407,2856509
LAB South,Brazil,2024,CSD,H2OH,Pull-Working,Consumer Promotions,Consumer Promotions Execution,50,4509552,2227839,2281713,837306,413651,423655
LAB South,Brazil,2024,CSD,H2OH,Pull-Working,Consumer Promotions,Coupons (Redemption),50,3594010,1733392,1860618,667314,321845,345469
LAB South,Brazil,2024,CSD,H2OH,Pull-Working,Consumer Promotions,Other Consumer Promotions,50,7751084,3916358,3834726,1439175,727166,712009
LAB South,Brazil,2024,CSD,H2OH,Pull-Working,Consumer Promotions,Premiums,50,228140,112054,116086,42359,20805,21554
LAB South,Brazil,2024,CSD,H2OH,Pull-Working,In Store & POS Execution,In-Store and POS Execution,50,225360,114137,111223,41843,21192,20651
LAB South,Brazil,2024,CSD,H2OH,Pull-Working,In Store & POS Execution,Other In-Store and POS Execution,50,3386791,1731273,1655518,628839,321452,307387
LAB South,Brazil,2024,CSD,H2OH,Pull-Working,Media Placements,Digital Media,50,3387856,1642463,1745393,629036,304962,324074
LAB South,Brazil,2024,CSD,H2OH,Pull-Working,Media Placements,Media Placements,50,13515075,7014986,6500089,2509398,1302500,1206898
LAB South,Brazil,2024,CSD,H2OH,Pull-Working,Media Placements,Other Media,50,13378474,6789584,6588890,2484035,1260649,1223386
LAB South,Brazil,2024,CSD,H2OH,Pull-Working,Other Working,All Other Working,50,8035481,4050097,3985384,1491980,751997,739983
LAB South,Brazil,2024,CSD,H2OH,Pull-Working,Other Working,W-Cross Charges,50,7747091,3912291,3834800,1438433,726410,712023
LAB South,Brazil,2024,CSD,H2OH,Pull-Working,Other Working,W-Excluded non-A&M Items,50,23797921,11708100,12089821,4418656,2173890,2244766
LAB South,Brazil,2024,CSD,H2OH,Pull-Working,Other Working,W-Fall In / Fall Out,50,4203127,2104876,2098251,780411,390820,389591
LAB South,Brazil,2024,CSD,H2OH,Pull-Working,Sampling,Other Sampling,50,52755,26239,26516,9795,4871,4924
LAB South,Brazil,2024,CSD,H2OH,Pull-Working,Sampling,Product Samples,50,691278,335091,356187,128352,62217,66135
LAB South,Brazil,2024,CSD,H2OH,Pull-Working,Sampling,Sample Executing,50,17037849,8138566,8899283,3163486,1511120,1652366
LAB South,Brazil,2024,CSD,H2OH,Pull-Working,Sponsorships,Other Sponsorships,50,21075333,10747815,10327518,3913142,1995590,1917552
LAB South,Brazil,2024,CSD,H2OH,Pull-Working,Sponsorships,Sponsorships,50,2059914,1020974,1038940,382472,189568,192904
LAB South,Brazil,2024,CSD,H2OH,STB - Push,Capability Building/Other,Capability Building,50,1250740,635395,615345,232229,117976,114253
LAB South,Brazil,2024,CSD,H2OH,STB - Push,Capability Building/Other,Capability Building/Other-Other,50,2060057,1017973,1042084,382499,189011,193488
LAB South,Brazil,2024,CSD,H2OH,STB - Push,Trade Equipment,On Premise Equipment,50,34150823,16496055,17654768,6340921,3062889,3278032
LAB South,Brazil,2024,CSD,H2OH,STB - Push,Trade Equipment,"Stands/ Racks, Other Trade Equipment",50,18157095,8788947,9368148,3371301,1631879,1739422
LAB South,Brazil,2024,CSD,H2OH,STB - Push,Trade Equipment,Trade Equipment-Other,50,6794216,3494263,3299953,1261509,648793,612716
LAB South,Brazil,2024,CSD,H2OH,STB - Push,Trade Programs,Distribution Incentives,50,1700971,857615,843356,315826,159236,156590
LAB South,Brazil,2024,CSD,H2OH,STB - Push,Trade Programs,Innovation Investments,0,0,0,0,0,0,0
LAB South,Brazil,2024,CSD,H2OH,STB - Push,Trade Programs,Other Trade Programs,50,28750611,14435127,14315484,5338242,2680228,2658014
LAB South,Brazil,2024,CSD,H2OH,STB - Push,Trade Programs,Sales Incentives,50,4617141,2404046,2213095,857283,446368,410915
LAB South,Brazil,2024,CSD,H2OH,STB - Push,Trade Programs,Space Investments,50,4624522,2390151,2234371,858653,443789,414864
LAB South,Brazil,2024,CSD,H2OH,STB - Push,Unilateral,CDAs,50,3152669,1571203,1581466,585368,291731,293637
LAB South,Brazil,2024,CSD,H2OH,STB - Push,Unilateral,Capital Equipment,50,26396117,12642050,13754067,4901074,2347300,2553774
LAB South,Brazil,2024,CSD,H2OH,STB - Push,Unilateral,Other Unilateral,50,1114630,526608,588022,206957,97777,109180
LAB South,Brazil,2024,CSD,H2OH,STB - Push,Unilateral,Price Support,50,1745665,868702,876963,324124,161295,162829
LAB South,Brazil,2024,RTD Tea,Lipton,Pull-Non-Working,Ad Production,Digital Ad Production,50,12051758,6065819,5985939,2237698,1126265,1111433
LAB South,Brazil,2024,RTD Tea,Lipton,Pull-Non-Working,Ad Production,Other Ad Production,50,7185487,3660866,3524621,1334158,679727,654431
LAB South,Brazil,2024,RTD Tea,Lipton,Pull-Non-Working,Ad Production,TV Print Radio OOH Prod,50,25829428,13052678,12776750,4795854,2423543,2372311
LAB South,Brazil,2024,RTD Tea,Lipton,Pull-Non-Working,Agency Fees,Creative Agency Fees,50,685424,364491,320933,127265,67676,59589
LAB South,Brazil,2024,RTD Tea,Lipton,Pull-Non-Working,Agency Fees,In Store and POS Design/Development,50,56167,28722,27445,10428,5332,5096
LAB South,Brazil,2024,RTD Tea,Lipton,Pull-Non-Working,Agency Fees,Media Agency Fees,50,287757,148189,139568,53429,27514,25915
LAB South,Brazil,2024,RTD Tea,Lipton,Pull-Non-Working,Agency Fees,Other Agency Fees,50,354027,183487,170540,65733,34068,31665
LAB South,Brazil,2024,RTD Tea,Lipton,Pull-Non-Working,Agency Fees,Social Media/Influence Marketing,50,705992,349668,356324,131084,64924,66160
LAB South,Brazil,2024,RTD Tea,Lipton,Pull-Non-Working,Innovation and Insight,Innovation,50,8719647,4554407,4165240,1619012,845635,773377
LAB South,Brazil,2024,RTD Tea,Lipton,Pull-Non-Working,Innovation and Insight,Market Research,50,1410972,713421,697551,261980,132463,129517
LAB South,Brazil,2024,RTD Tea,Lipton,Pull-Non-Working,Innovation and Insight,Other Innovation and Insight,50,1405212,705924,699288,260911,131071,129840
LAB South,Brazil,2024,RTD Tea,Lipton,Pull-Non-Working,Insight,Advanced Analytics,50,3688999,1851259,1837740,684951,343730,341221
LAB South,Brazil,2024,RTD Tea,Lipton,Pull-Non-Working,Insight,Brand Building,50,1039917,510805,529112,193085,94843,98242
LAB South,Brazil,2024,RTD Tea,Lipton,Pull-Non-Working,Insight,Consumer Tracking,50,535754,265661,270093,99475,49326,50149
LAB South,Brazil,2024,RTD Tea,Lipton,Pull-Non-Working,Insight,Customer / Retail and Insights and Analytics,50,2158925,1056639,1102286,400856,196190,204666
LAB South,Brazil,2024,RTD Tea,Lipton,Pull-Non-Working,Insight,Foundational Data / Systems,50,3630073,1858167,1771906,674010,345013,328997
LAB South,Brazil,2024,RTD Tea,Lipton,Pull-Non-Working,Insight,Innovation Insights,50,3700816,1819925,1880891,687145,337912,349233
LAB South,Brazil,2024,RTD Tea,Lipton,Pull-Non-Working,Insight,Strategic Insights,50,3333901,1724930,1608971,619018,320274,298744
LAB South,Brazil,2024,RTD Tea,Lipton,Pull-Non-Working,Other Non Working,All Other Non Working,50,253407,126159,127248,47051,23424,23627
LAB South,Brazil,2024,RTD Tea,Lipton,Pull-Non-Working,Other Non Working,NW-Cross Charges,50,3743361,1851923,1891438,695045,343854,351191
LAB South,Brazil,2024,RTD Tea,Lipton,Pull-Non-Working,Other Non Working,NW-Excluded non-A&M Items,50,224002698,114632000,109370698,41591489,21284188,20307301
LAB South,Brazil,2024,RTD Tea,Lipton,Pull-Non-Working,Other Non Working,NW-Fall In / Fall Out,50,42119019,20964105,21154914,7820409,3892490,3927919
LAB South,Brazil,2024,RTD Tea,Lipton,Pull-Non-Working,Other Non Working,Out of Scope Countries ( D8 Gastos),50,22362708,11251177,11111531,4152174,2089051,2063123
LAB South,Brazil,2024,RTD Tea,Lipton,Pull-Non-Working,Package Design,Other Package Design,50,4314383,2063660,2250723,801068,383168,417900
LAB South,Brazil,2024,RTD Tea,Lipton,Pull-Non-Working,Package Design,Package Design,50,4279616,2110427,2169189,794613,391851,402762
LAB South,Brazil,2024,RTD Tea,Lipton,Pull-Working,Consumer Promotions,Consumer Promotions Execution,50,4445039,2194256,2250783,825328,407416,417912
LAB South,Brazil,2024,RTD Tea,Lipton,Pull-Working,Consumer Promotions,Coupons (Redemption),50,4603112,2269806,2333306,854678,421444,433234
LAB South,Brazil,2024,RTD Tea,Lipton,Pull-Working,Consumer Promotions,Other Consumer Promotions,50,7139754,3438892,3700862,1325667,638513,687154
LAB South,Brazil,2024,RTD Tea,Lipton,Pull-Working,Consumer Promotions,Premiums,50,2840263,1390665,1449598,527363,258210,269153
LAB South,Brazil,2024,RTD Tea,Lipton,Pull-Working,In Store & POS Execution,In-Store and POS Execution,50,9938340,4851976,5086364,1845291,900886,944405
LAB South,Brazil,2024,RTD Tea,Lipton,Pull-Working,In Store & POS Execution,Other In-Store and POS Execution,50,44527472,21914840,22612632,8267596,4069017,4198579
LAB South,Brazil,2024,RTD Tea,Lipton,Pull-Working,Media Placements,Digital Media,50,1902163,953869,948294,353182,177108,176074
LAB South,Brazil,2024,RTD Tea,Lipton,Pull-Working,Media Placements,Media Placements,50,1979498,980041,999457,367541,181968,185573
LAB South,Brazil,2024,RTD Tea,Lipton,Pull-Working,Media Placements,Other Media,50,1069086,515942,553144,198501,95797,102704
LAB South,Brazil,2024,RTD Tea,Lipton,Pull-Working,Other Working,All Other Working,50,6785592,3558050,3227542,1259908,660637,599271
LAB South,Brazil,2024,RTD Tea,Lipton,Pull-Working,Other Working,W-Cross Charges,50,11674255,5807557,5866698,2167606,1078312,1089294
LAB South,Brazil,2024,RTD Tea,Lipton,Pull-Working,Other Working,W-Excluded non-A&M Items,50,4454084,2195079,2259005,827007,407569,419438
LAB South,Brazil,2024,RTD Tea,Lipton,Pull-Working,Other Working,W-Fall In / Fall Out,50,8184892,4133047,4051845,1519722,767399,752323
LAB South,Brazil,2024,RTD Tea,Lipton,Pull-Working,Sampling,Other Sampling,50,12819318,6501297,6318021,2380214,1207122,1173092
LAB South,Brazil,2024,RTD Tea,Lipton,Pull-Working,Sampling,Product Samples,50,5185832,2515507,2670325,962874,467064,495810
LAB South,Brazil,2024,RTD Tea,Lipton,Pull-Working,Sampling,Sample Executing,50,16408537,8123498,8285039,3046639,1508322,1538317
LAB South,Brazil,2024,RTD Tea,Lipton,Pull-Working,Sponsorships,Other Sponsorships,50,18974320,9376768,9597552,3523038,1741022,1782016
LAB South,Brazil,2024,RTD Tea,Lipton,Pull-Working,Sponsorships,Sponsorships,50,144542366,69477943,75064423,26837767,12900251,13937516
LAB South,Brazil,2024,RTD Tea,Lipton,STB - Push,Capability Building/Other,Capability Building,50,121645971,63308343,58337628,22586500,11754716,10831784
LAB South,Brazil,2024,RTD Tea,Lipton,STB - Push,Capability Building/Other,Capability Building/Other-Other,50,121407291,59402832,62004459,22542184,11029564,11512620
LAB South,Brazil,2024,RTD Tea,Lipton,STB - Push,Trade Equipment,On Premise Equipment,50,843941,424406,419535,156697,78801,77896
LAB South,Brazil,2024,RTD Tea,Lipton,STB - Push,Trade Equipment,"Stands/ Racks, Other Trade Equipment",50,14431358,6805003,7626355,2679528,1263512,1416016
LAB South,Brazil,2024,RTD Tea,Lipton,STB - Push,Trade Equipment,Trade Equipment-Other,50,3684996,1920513,1764483,684208,356589,327619
LAB South,Brazil,2024,RTD Tea,Lipton,STB - Push,Trade Programs,Distribution Incentives,50,18186501,9645790,8540711,3376761,1790972,1585789
LAB South,Brazil,2024,RTD Tea,Lipton,STB - Push,Trade Programs,Innovation Investments,50,18900076,9417025,9483051,3509253,1748497,1760756
LAB South,Brazil,2024,RTD Tea,Lipton,STB - Push,Trade Programs,Other Trade Programs,50,3778288,1912585,1865703,701530,355117,346413
LAB South,Brazil,2024,RTD Tea,Lipton,STB - Push,Trade Programs,Sales Incentives,50,170375,86741,83634,31634,16105,15529
LAB South,Brazil,2024,RTD Tea,Lipton,STB - Push,Trade Programs,Space Investments,50,1355899,670919,684980,251755,124572,127183
LAB South,Brazil,2024,RTD Tea,Lipton,STB - Push,Unilateral,CDAs,50,4209717,2240112,1969605,781635,415930,365705
LAB South,Brazil,2024,RTD Tea,Lipton,STB - Push,Unilateral,Capital Equipment,0,0,0,0,0,0,0
LAB South,Brazil,2024,RTD Tea,Lipton,STB - Push,Unilateral,Other Unilateral,50,29255574,15074752,14180822,5432001,2798990,2633011
LAB South,Brazil,2024,RTD Tea,Lipton,STB - Push,Unilateral,Price Support,50,28891018,14128029,14762989,5364312,2623208,2741104
LAB South,Brazil,2024,CSD,Pepsi,Pull-Non-Working,Ad Production,Digital Ad Production,50,3998277,1981496,2016781,742376,367912,374464
LAB South,Brazil,2024,CSD,Pepsi,Pull-Non-Working,Ad Production,Other Ad Production,50,3525424,1826070,1699354,654579,339053,315526
LAB South,Brazil,2024,CSD,Pepsi,Pull-Non-Working,Ad Production,TV Print Radio OOH Prod,50,308913,159188,149725,57357,29557,27800
LAB South,Brazil,2024,CSD,Pepsi,Pull-Non-Working,Agency Fees,Creative Agency Fees,50,3442407,1733084,1709323,639165,321788,317377
LAB South,Brazil,2024,CSD,Pepsi,Pull-Non-Working,Agency Fees,In Store and POS Design/Development,50,2858128,1427602,1430526,530680,265068,265612
LAB South,Brazil,2024,CSD,Pepsi,Pull-Non-Working,Agency Fees,Media Agency Fees,50,631924,320315,311609,117331,59474,57857
LAB South,Brazil,2024,CSD,Pepsi,Pull-Non-Working,Agency Fees,Other Agency Fees,50,6962094,3584858,3377236,1292680,665615,627065
LAB South,Brazil,2024,CSD,Pepsi,Pull-Non-Working,Agency Fees,Social Media/Influence Marketing,50,7164405,3430343,3734062,1330244,636925,693319
LAB South,Brazil,2024,CSD,Pepsi,Pull-Non-Working,Innovation and Insight,Innovation,50,1107052,567669,539383,205550,105401,100149
LAB South,Brazil,2024,CSD,Pepsi,Pull-Non-Working,Innovation and Insight,Market Research,50,404393,211268,193125,75085,39226,35859
LAB South,Brazil,2024,CSD,Pepsi,Pull-Non-Working,Innovation and Insight,Other Innovation and Insight,50,414270,205484,208786,76919,38153,38766
LAB South,Brazil,2024,CSD,Pepsi,Pull-Non-Working,Insight,Advanced Analytics,50,736474,365671,370803,136744,67895,68849
LAB South,Brazil,2024,CSD,Pepsi,Pull-Non-Working,Insight,Brand Building,50,725325,356505,368820,134674,66193,68481
LAB South,Brazil,2024,CSD,Pepsi,Pull-Non-Working,Insight,Consumer Tracking,50,22980152,11242115,11738037,4266818,2087369,2179449
LAB South,Brazil,2024,CSD,Pepsi,Pull-Non-Working,Insight,Customer / Retail and Insights and Analytics,50,5504733,2605530,2899203,1022086,483779,538307
LAB South,Brazil,2024,CSD,Pepsi,Pull-Non-Working,Insight,Foundational Data / Systems,50,833908,431678,402230,154835,80151,74684
LAB South,Brazil,2024,CSD,Pepsi,Pull-Non-Working,Insight,Innovation Insights,50,1144617,566782,577835,212525,105236,107289
LAB South,Brazil,2024,CSD,Pepsi,Pull-Non-Working,Insight,Strategic Insights,50,3230564,1602821,1627743,599831,297602,302229
LAB South,Brazil,2024,CSD,Pepsi,Pull-Non-Working,Other Non Working,All Other Non Working,50,1863653,931994,931659,346032,173047,172985
LAB South,Brazil,2024,CSD,Pepsi,Pull-Non-Working,Other Non Working,NW-Cross Charges,50,52724,25478,27246,9789,4730,5059
LAB South,Brazil,2024,CSD,Pepsi,Pull-Non-Working,Other Non Working,NW-Excluded non-A&M Items,50,310258,154389,155869,57606,28666,28940
LAB South,Brazil,2024,CSD,Pepsi,Pull-Non-Working,Other Non Working,NW-Fall In / Fall Out,50,1560517,761928,798589,289747,141470,148277
LAB South,Brazil,2024,CSD,Pepsi,Pull-Non-Working,Other Non Working,Out of Scope Countries ( D8 Gastos),50,15741703,7649419,8092284,2922825,1420298,1502527
LAB South,Brazil,2024,CSD,Pepsi,Pull-Non-Working,Package Design,Other Package Design,50,15915614,7785130,8130484,2955116,1445496,1509620
LAB South,Brazil,2024,CSD,Pepsi,Pull-Non-Working,Package Design,Package Design,50,33499636,16213792,17285844,6220013,3010480,3209533
LAB South,Brazil,2024,CSD,Pepsi,Pull-Working,Consumer Promotions,Consumer Promotions Execution,50,4465914,2192778,2273136,829204,407141,422063
LAB South,Brazil,2024,CSD,Pepsi,Pull-Working,Consumer Promotions,Coupons (Redemption),50,3402187,1721562,1680625,631697,319649,312048
LAB South,Brazil,2024,CSD,Pepsi,Pull-Working,Consumer Promotions,Other Consumer Promotions,50,7867505,3941614,3925891,1460791,731855,728936
LAB South,Brazil,2024,CSD,Pepsi,Pull-Working,Consumer Promotions,Premiums,50,226523,113937,112586,42059,21155,20904
LAB South,Brazil,2024,CSD,Pepsi,Pull-Working,In Store & POS Execution,In-Store and POS Execution,50,227756,111136,116620,42288,20635,21653
LAB South,Brazil,2024,CSD,Pepsi,Pull-Working,In Store & POS Execution,Other In-Store and POS Execution,50,3373333,1672186,1701147,626340,310481,315859
LAB South,Brazil,2024,CSD,Pepsi,Pull-Working,Media Placements,Digital Media,50,3411187,1689975,1721212,633368,313784,319584
LAB South,Brazil,2024,CSD,Pepsi,Pull-Working,Media Placements,Media Placements,50,13542492,6752723,6789769,2514489,1253805,1260684
LAB South,Brazil,2024,CSD,Pepsi,Pull-Working,Media Placements,Other Media,50,13472636,6957412,6515224,2501518,1291810,1209708
LAB South,Brazil,2024,CSD,Pepsi,Pull-Working,Other Working,All Other Working,50,7629636,3990562,3639074,1416625,740943,675682
LAB South,Brazil,2024,CSD,Pepsi,Pull-Working,Other Working,W-Cross Charges,50,8066069,4013346,4052723,1497659,745174,752485
LAB South,Brazil,2024,CSD,Pepsi,Pull-Working,Other Working,W-Excluded non-A&M Items,50,23623923,12224837,11399086,4386349,2269835,2116514
LAB South,Brazil,2024,CSD,Pepsi,Pull-Working,Other Working,W-Fall In / Fall Out,50,4252978,2189958,2063020,789667,406618,383049
LAB South,Brazil,2024,CSD,Pepsi,Pull-Working,Sampling,Other Sampling,50,52690,27233,25457,9783,5056,4727
LAB South,Brazil,2024,CSD,Pepsi,Pull-Working,Sampling,Product Samples,50,701367,334235,367132,130225,62058,68167
LAB South,Brazil,2024,CSD,Pepsi,Pull-Working,Sampling,Sample Executing,50,17355516,8518735,8836781,3222469,1581708,1640761
LAB South,Brazil,2024,CSD,Pepsi,Pull-Working,Sponsorships,Other Sponsorships,50,21977947,10853155,11124792,4080734,2015149,2065585
LAB South,Brazil,2024,CSD,Pepsi,Pull-Working,Sponsorships,Sponsorships,50,2000982,1023553,977429,371530,190047,181483
LAB South,Brazil,2024,CSD,Pepsi,STB - Push,Capability Building/Other,Capability Building,50,1232598,644672,587926,228861,119698,109163
LAB South,Brazil,2024,CSD,Pepsi,STB - Push,Capability Building/Other,Capability Building/Other-Other,50,2131638,1048937,1082701,395789,194760,201029
LAB South,Brazil,2024,CSD,Pepsi,STB - Push,Trade Equipment,On Premise Equipment,50,32819803,17213900,15605903,6093785,3196174,2897611
LAB South,Brazil,2024,CSD,Pepsi,STB - Push,Trade Equipment,"Stands/ Racks, Other Trade Equipment",50,18111675,8967785,9143890,3362868,1665085,1697783
LAB South,Brazil,2024,CSD,Pepsi,STB - Push,Trade Equipment,Trade Equipment-Other,50,6811295,3538751,3272544,1264680,657054,607626
LAB South,Brazil,2024,CSD,Pepsi,STB - Push,Trade Programs,Distribution Incentives,50,1704624,839992,864632,316504,155964,160540
LAB South,Brazil,2024,CSD,Pepsi,STB - Push,Trade Programs,Innovation Investments,50,2623382,1324731,1298651,487093,245968,241125
LAB South,Brazil,2024,CSD,Pepsi,STB - Push,Trade Programs,Other Trade Programs,50,29010669,14654437,14356232,5386528,2720948,2665580
LAB South,Brazil,2024,CSD,Pepsi,STB - Push,Trade Programs,Sales Incentives,50,4755005,2449804,2305201,882881,454865,428016
LAB South,Brazil,2024,CSD,Pepsi,STB - Push,Trade Programs,Space Investments,50,4821667,2337103,2484564,895258,433939,461319
LAB South,Brazil,2024,CSD,Pepsi,STB - Push,Unilateral,CDAs,50,3029444,1562664,1466780,562489,290146,272343
LAB South,Brazil,2024,CSD,Pepsi,STB - Push,Unilateral,Capital Equipment,0,0,0,0,0,0,0
LAB South,Brazil,2024,CSD,Pepsi,STB - Push,Unilateral,Other Unilateral,50,1089468,541111,548357,202285,100470,101815
LAB South,Brazil,2024,CSD,Pepsi,STB - Push,Unilateral,Price Support,50,1721890,841003,880887,319710,156152,163558
LAB South,Brazil,2024,CSD,TEEM,Pull-Non-Working,Ad Production,Digital Ad Production,50,12538694,6239658,6299036,2328110,1158542,1169568
LAB South,Brazil,2024,CSD,TEEM,Pull-Non-Working,Ad Production,Other Ad Production,50,7530653,3688837,3841816,1398246,684921,713325
LAB South,Brazil,2024,CSD,TEEM,Pull-Non-Working,Ad Production,TV Print Radio OOH Prod,50,26491894,13175122,13316772,4918857,2446278,2472579
LAB South,Brazil,2024,CSD,TEEM,Pull-Non-Working,Agency Fees,Creative Agency Fees,50,727153,354356,372797,135013,65794,69219
LAB South,Brazil,2024,CSD,TEEM,Pull-Non-Working,Agency Fees,In Store and POS Design/Development,50,56404,26880,29524,10472,4990,5482
LAB South,Brazil,2024,CSD,TEEM,Pull-Non-Working,Agency Fees,Media Agency Fees,50,285457,139601,145856,53001,25920,27081
LAB South,Brazil,2024,CSD,TEEM,Pull-Non-Working,Agency Fees,Other Agency Fees,50,368538,179821,188717,68427,33388,35039
LAB South,Brazil,2024,CSD,TEEM,Pull-Non-Working,Agency Fees,Social Media/Influence Marketing,50,709071,343146,365925,131656,63713,67943
LAB South,Brazil,2024,CSD,TEEM,Pull-Non-Working,Innovation and Insight,Innovation,50,8829727,4561002,4268725,1639451,846859,792592
LAB South,Brazil,2024,CSD,TEEM,Pull-Non-Working,Innovation and Insight,Market Research,50,1467035,744275,722760,272390,138192,134198
LAB South,Brazil,2024,CSD,TEEM,Pull-Non-Working,Innovation and Insight,Other Innovation and Insight,50,1490049,715847,774202,276663,132914,143749
LAB South,Brazil,2024,CSD,TEEM,Pull-Non-Working,Insight,Advanced Analytics,50,3665550,1895533,1770017,680597,351951,328646
LAB South,Brazil,2024,CSD,TEEM,Pull-Non-Working,Insight,Brand Building,50,1074955,527183,547772,199591,97884,101707
LAB South,Brazil,2024,CSD,TEEM,Pull-Non-Working,Insight,Consumer Tracking,50,563935,270738,293197,104708,50269,54439
LAB South,Brazil,2024,CSD,TEEM,Pull-Non-Working,Insight,Customer / Retail and Insights and Analytics,50,2117377,1054303,1063074,393141,195756,197385
LAB South,Brazil,2024,CSD,TEEM,Pull-Non-Working,Insight,Foundational Data / Systems,50,3670631,1921200,1749431,681540,356716,324824
LAB South,Brazil,2024,CSD,TEEM,Pull-Non-Working,Insight,Innovation Insights,50,3703293,1854124,1849169,687605,344262,343343
LAB South,Brazil,2024,CSD,TEEM,Pull-Non-Working,Insight,Strategic Insights,50,3328207,1735723,1592484,617961,322278,295683
LAB South,Brazil,2024,CSD,TEEM,Pull-Non-Working,Other Non Working,All Other Non Working,50,260362,127952,132410,48342,23757,24585
LAB South,Brazil,2024,CSD,TEEM,Pull-Non-Working,Other Non Working,NW-Cross Charges,50,3741649,1879060,1862589,694727,348892,345835
LAB South,Brazil,2024,CSD,TEEM,Pull-Non-Working,Other Non Working,NW-Excluded non-A&M Items,50,231280196,111708966,119571230,42942732,20741456,22201276
LAB South,Brazil,2024,CSD,TEEM,Pull-Non-Working,Other Non Working,NW-Fall In / Fall Out,50,40306039,20767846,19538193,7483785,3856050,3627735
LAB South,Brazil,2024,CSD,TEEM,Pull-Non-Working,Other Non Working,Out of Scope Countries ( D8 Gastos),50,21883477,10822931,11060546,4063193,2009537,2053656
LAB South,Brazil,2024,CSD,TEEM,Pull-Non-Working,Package Design,Other Package Design,50,4306265,2140567,2165698,799561,397447,402114
LAB South,Brazil,2024,CSD,TEEM,Pull-Non-Working,Package Design,Package Design,50,4377571,2172592,2204979,812801,403393,409408
LAB South,Brazil,2024,CSD,TEEM,Pull-Working,Consumer Promotions,Consumer Promotions Execution,50,4510071,2194237,2315834,837403,407412,429991
LAB South,Brazil,2024,CSD,TEEM,Pull-Working,Consumer Promotions,Coupons (Redemption),50,4568580,2152803,2415777,848266,399719,448547
LAB South,Brazil,2024,CSD,TEEM,Pull-Working,Consumer Promotions,Other Consumer Promotions,50,7050481,3544164,3506317,1309091,658059,651032
LAB South,Brazil,2024,CSD,TEEM,Pull-Working,Consumer Promotions,Premiums,50,2848330,1400615,1447715,528860,260057,268803
LAB South,Brazil,2024,CSD,TEEM,Pull-Working,In Store & POS Execution,In-Store and POS Execution,50,9845890,4974879,4871011,1828126,923705,904421
LAB South,Brazil,2024,CSD,TEEM,Pull-Working,In Store & POS Execution,Other In-Store and POS Execution,50,43467278,21394625,22072653,8070745,3972426,4098319
LAB South,Brazil,2024,CSD,TEEM,Pull-Working,Media Placements,Digital Media,50,1929075,936541,992534,358179,173891,184288
LAB South,Brazil,2024,CSD,TEEM,Pull-Working,Media Placements,Media Placements,50,2047935,1026467,1021468,380248,190588,189660
LAB South,Brazil,2024,CSD,TEEM,Pull-Working,Media Placements,Other Media,50,1040556,548682,491874,193204,101876,91328
LAB South,Brazil,2024,CSD,TEEM,Pull-Working,Other Working,All Other Working,50,7038775,3555339,3483436,1306917,660134,646783
LAB South,Brazil,2024,CSD,TEEM,Pull-Working,Other Working,W-Cross Charges,50,12201572,6041225,6160347,2265515,1121698,1143817
LAB South,Brazil,2024,CSD,TEEM,Pull-Working,Other Working,W-Excluded non-A&M Items,50,4272186,2144495,2127691,793234,398177,395057
LAB South,Brazil,2024,CSD,TEEM,Pull-Working,Other Working,W-Fall In / Fall Out,50,8690133,4103595,4586538,1613532,761931,851601
LAB South,Brazil,2024,CSD,TEEM,Pull-Working,Sampling,Other Sampling,50,12932026,6317054,6614972,2401141,1172913,1228228
LAB South,Brazil,2024,CSD,TEEM,Pull-Working,Sampling,Product Samples,50,5231238,2678258,2552980,971305,497283,474022
LAB South,Brazil,2024,CSD,TEEM,Pull-Working,Sampling,Sample Executing,50,16837306,8043359,8793947,3126250,1493443,1632807
LAB South,Brazil,2024,CSD,TEEM,Pull-Working,Sponsorships,Other Sponsorships,50,19146904,9350046,9796858,3555083,1736060,1819023
LAB South,Brazil,2024,CSD,TEEM,Pull-Working,Sponsorships,Sponsorships,50,141119025,72267396,68851629,26202141,13418180,12783961
LAB South,Brazil,2024,CSD,TEEM,STB - Push,Capability Building/Other,Capability Building,50,125815152,61715100,64100052,23360609,11458892,11901717
LAB South,Brazil,2024,CSD,TEEM,STB - Push,Capability Building/Other,Capability Building/Other-Other,50,126270758,62381966,63888792,23445203,11582712,11862491
LAB South,Brazil,2024,CSD,TEEM,STB - Push,Trade Equipment,On Premise Equipment,50,866442,420682,445760,160875,78109,82766
LAB South,Brazil,2024,CSD,TEEM,STB - Push,Trade Equipment,"Stands/ Racks, Other Trade Equipment",50,13569268,6976342,6592926,2519461,1295325,1224136
LAB South,Brazil,2024,CSD,TEEM,STB - Push,Trade Equipment,Trade Equipment-Other,50,3903981,1868475,2035506,724867,346927,377940
LAB South,Brazil,2024,CSD,TEEM,STB - Push,Trade Programs,Distribution Incentives,50,18580337,9228951,9351386,3449886,1713576,1736310
LAB South,Brazil,2024,CSD,TEEM,STB - Push,Trade Programs,Innovation Investments,50,19512887,9367831,10145056,3623036,1739363,1883673
LAB South,Brazil,2024,CSD,TEEM,STB - Push,Trade Programs,Other Trade Programs,50,3873051,1893995,1979056,719125,351665,367460
LAB South,Brazil,2024,CSD,TEEM,STB - Push,Trade Programs,Sales Incentives,50,167332,84122,83210,31069,15619,15450
LAB South,Brazil,2024,CSD,TEEM,STB - Push,Trade Programs,Space Investments,50,1430437,702035,728402,265595,130349,135246
LAB South,Brazil,2024,CSD,TEEM,STB - Push,Unilateral,CDAs,50,4221658,2137110,2084548,783852,396805,387047
LAB South,Brazil,2024,CSD,TEEM,STB - Push,Unilateral,Capital Equipment,0,0,0,0,0,0,0
LAB South,Brazil,2024,CSD,TEEM,STB - Push,Unilateral,Other Unilateral,50,29274306,14590553,14683753,5435479,2709087,2726392
LAB South,Brazil,2024,CSD,TEEM,STB - Push,Unilateral,Price Support,50,28265136,14119988,14145148,5248102,2621715,2626387
LAB North,El Salvador,2024,Sport Drinks,Gatorade,Pull-Non-Working,Ad Production,Digital Ad Production,0,0,0,0,0,0,0
LAB North,El Salvador,2024,Sport Drinks,Gatorade,Pull-Non-Working,Ad Production,"TV, Print, Radio, OOH, Production",0,0,0,0,0,0,0
LAB North,El Salvador,2024,Sport Drinks,Gatorade,Pull-Non-Working,Agency Fees,Creative Agency Fees,50,8775,4404,4371,8775,4404,4371
LAB North,El Salvador,2024,Sport Drinks,Gatorade,Pull-Non-Working,Agency Fees,In Store & POS Design / Development,0,0,0,0,0,0,0
LAB North,El Salvador,2024,Sport Drinks,Gatorade,Pull-Non-Working,Agency Fees,Media Agency Fees,50,106331,52980,53351,106331,52980,53351
LAB North,El Salvador,2024,Sport Drinks,Gatorade,Pull-Non-Working,Agency Fees,Other,50,41678,20873,20805,41678,20873,20805
LAB North,El Salvador,2024,Sport Drinks,Gatorade,Pull-Non-Working,Agency Fees,Social Media / Influence Marketing,0,0,0,0,0,0,0
LAB North,El Salvador,2024,Sport Drinks,Gatorade,Pull-Non-Working,All Other Non-Working,Administrative fees,0,0,0,0,0,0,0
LAB North,El Salvador,2024,Sport Drinks,Gatorade,Pull-Non-Working,All Other Non-Working,Agency out of pocket,0,0,0,0,0,0,0
LAB North,El Salvador,2024,Sport Drinks,Gatorade,Pull-Non-Working,All Other Non-Working,CP out of pocket admin,0,0,0,0,0,0,0
LAB North,El Salvador,2024,Sport Drinks,Gatorade,Pull-Non-Working,All Other Non-Working,Grassroots/experiential out of pocket,0,0,0,0,0,0,0
LAB North,El Salvador,2024,Sport Drinks,Gatorade,Pull-Non-Working,All Other Non-Working,League/property- rights fee/options,0,0,0,0,0,0,0
LAB North,El Salvador,2024,Sport Drinks,Gatorade,Pull-Non-Working,All Other Non-Working,Market Research,0,0,0,0,0,0,0
LAB North,El Salvador,2024,Sport Drinks,Gatorade,Pull-Non-Working,All Other Non-Working,Non-allocated NW,0,0,0,0,0,0,0
LAB North,El Salvador,2024,Sport Drinks,Gatorade,Pull-Non-Working,All Other Non-Working,Other Non Working-non itemised talent,0,0,0,0,0,0,0
LAB North,El Salvador,2024,Sport Drinks,Gatorade,Pull-Non-Working,All Other Non-Working,PR out of pocket administrative,0,0,0,0,0,0,0
LAB North,El Salvador,2024,Sport Drinks,Gatorade,Pull-Non-Working,Innovation and Insight,Innovations,0,0,0,0,0,0,0
LAB North,El Salvador,2024,Sport Drinks,Gatorade,Pull-Non-Working,Innovation and Insight,Market Research,0,0,0,0,0,0,0
LAB North,El Salvador,2024,Sport Drinks,Gatorade,Pull-Non-Working,Package Design,Package design,0,0,0,0,0,0,0
LAB North,El Salvador,2024,Sport Drinks,Gatorade,Pull-Non-Working,Package Design,Package development,50,36121,18332,17789,36121,18332,17789
LAB North,El Salvador,2024,Sport Drinks,Gatorade,STB - Push,Capability Building/Other,Capability Building Other,50,50715,26544,24171,50715,26544,24171
LAB North,El Salvador,2024,Sport Drinks,Gatorade,STB - Push,Other Investments,CDA's,50,116616,55971,60645,116616,55971,60645
LAB North,El Salvador,2024,Sport Drinks,Gatorade,STB - Push,Other Investments,Capital (Coolers),0,0,0,0,0,0,0
LAB North,El Salvador,2024,Sport Drinks,Gatorade,STB - Push,Other Investments,Price Support,50,614694,302246,312448,614694,302246,312448
LAB North,El Salvador,2024,Sport Drinks,Gatorade,STB - Push,Other Investments,Vending / Racks,0,0,0,0,0,0,0
LAB North,El Salvador,2024,Sport Drinks,Gatorade,STB - Push,Other Trade,Frozen Funds,0,0,0,0,0,0,0
LAB North,El Salvador,2024,Sport Drinks,Gatorade,STB - Push,Other Trade,Other Trade,0,0,0,0,0,0,0
LAB North,El Salvador,2024,Sport Drinks,Gatorade,STB - Push,Trade Equipment,Coolers - New,0,0,0,0,0,0,0
LAB North,El Salvador,2024,Sport Drinks,Gatorade,STB - Push,Trade Equipment,Coolers - Refurbished,0,0,0,0,0,0,0
LAB North,El Salvador,2024,Sport Drinks,Gatorade,STB - Push,Trade Equipment,Post Mix / Pre Mix Equip.,0,0,0,0,0,0,0
LAB North,El Salvador,2024,Sport Drinks,Gatorade,STB - Push,Trade Equipment,Vending / Racks,0,0,0,0,0,0,0
LAB North,El Salvador,2024,Sport Drinks,Gatorade,STB - Push,Trade Programs,Distribution Incentives,0,0,0,0,0,0,0
LAB North,El Salvador,2024,Sport Drinks,Gatorade,STB - Push,Trade Programs,Innovation Investments,0,0,0,0,0,0,0
LAB North,El Salvador,2024,Sport Drinks,Gatorade,STB - Push,Trade Programs,Sales Incentives,0,0,0,0,0,0,0
LAB North,El Salvador,2024,Sport Drinks,Gatorade,STB - Push,Trade Programs,Space Investments,50,1306315,671178,635137,1306315,671178,635137
LAB North,El Salvador,2024,Sport Drinks,Gatorade,Pull-Working,All Other Working,Other Working - PR execution,0,0,0,0,0,0,0
LAB North,El Salvador,2024,Sport Drinks,Gatorade,Pull-Working,All Other Working,Other Working - activation,50,109653,56787,52866,109653,56787,52866
LAB North,El Salvador,2024,Sport Drinks,Gatorade,Pull-Working,All Other Working,Other Working - non allocated working,0,0,0,0,0,0,0
LAB North,El Salvador,2024,Sport Drinks,Gatorade,Pull-Working,Consumer Promotions,Consumer Promotions Execution,50,33832,16889,16943,33832,16889,16943
LAB North,El Salvador,2024,Sport Drinks,Gatorade,Pull-Working,Consumer Promotions,Coupons,50,418200,214582,203618,418200,214582,203618
LAB North,El Salvador,2024,Sport Drinks,Gatorade,Pull-Working,Consumer Promotions,Other,0,0,0,0,0,0,0
LAB North,El Salvador,2024,Sport Drinks,Gatorade,Pull-Working,Consumer Promotions,Premiums,50,14478,7264,7214,14478,7264,7214
LAB North,El Salvador,2024,Sport Drinks,Gatorade,Pull-Working,In Store & POS Execution,In-Store & POS Execution,50,40124,20480,19644,40124,20480,19644
LAB North,El Salvador,2024,Sport Drinks,Gatorade,Pull-Working,Media Placements,Cinema,0,0,0,0,0,0,0
LAB North,El Salvador,2024,Sport Drinks,Gatorade,Pull-Working,Media Placements,Digital,50,221628,112184,109444,221628,112184,109444
LAB North,El Salvador,2024,Sport Drinks,Gatorade,Pull-Working,Media Placements,OOH - Out Of Home,0,0,0,0,0,0,0
LAB North,El Salvador,2024,Sport Drinks,Gatorade,Pull-Working,Media Placements,Other,0,0,0,0,0,0,0
LAB North,El Salvador,2024,Sport Drinks,Gatorade,Pull-Working,Media Placements,Print,0,0,0,0,0,0,0
LAB North,El Salvador,2024,Sport Drinks,Gatorade,Pull-Working,Media Placements,Radio,50,97454,47593,49861,97454,47593,49861
LAB North,El Salvador,2024,Sport Drinks,Gatorade,Pull-Working,Media Placements,TV,0,0,0,0,0,0,0
LAB North,El Salvador,2024,Sport Drinks,Gatorade,Pull-Working,Sampling,Product Samples,0,0,0,0,0,0,0
LAB North,El Salvador,2024,Sport Drinks,Gatorade,Pull-Working,Sampling,Sampling Execution,0,0,0,0,0,0,0
LAB North,El Salvador,2024,Sport Drinks,Gatorade,Pull-Working,Sponsorships,Sponsorships-in game/ in show,50,119955,59734,60221,119955,59734,60221
LAB North,El Salvador,2024,Sport Drinks,Gatorade,Pull-Working,Sponsorships,Sports-athlete/team contracts,50,68602,35779,32823,68602,35779,32823
LAB North,El Salvador,2024,Sport Drinks,Gatorade,Pull-Working,Sponsorships,Sports-on field or in show props,0,0,0,0,0,0,0
LAB North,El Salvador,2024,Sport Drinks,Gatorade,Pull-Working,Sponsorships,Sports-stadium contracts,0,0,0,0,0,0,0
LAB North,El Salvador,2024,CSD,Pepsi,Pull-Non-Working,Ad Production,Digital Ad Production,0,0,0,0,0,0,0
LAB North,El Salvador,2024,CSD,Pepsi,Pull-Non-Working,Ad Production,"TV, Print, Radio, OOH, Production",0,0,0,0,0,0,0
LAB North,El Salvador,2024,CSD,Pepsi,Pull-Non-Working,Agency Fees,Creative Agency Fees,0,0,0,0,0,0,0
LAB North,El Salvador,2024,CSD,Pepsi,Pull-Non-Working,Agency Fees,In Store & POS Design / Development,0,0,0,0,0,0,0
LAB North,El Salvador,2024,CSD,Pepsi,Pull-Non-Working,Agency Fees,Media Agency Fees,50,221516,108260,113256,221516,108260,113256
LAB North,El Salvador,2024,CSD,Pepsi,Pull-Non-Working,Agency Fees,Other,50,39356,19162,20194,39356,19162,20194
LAB North,El Salvador,2024,CSD,Pepsi,Pull-Non-Working,Agency Fees,Social Media / Influence Marketing,0,0,0,0,0,0,0
LAB North,El Salvador,2024,CSD,Pepsi,Pull-Non-Working,All Other Non-Working,Administrative fees,0,0,0,0,0,0,0
LAB North,El Salvador,2024,CSD,Pepsi,Pull-Non-Working,All Other Non-Working,Agency out of pocket,0,0,0,0,0,0,0
LAB North,El Salvador,2024,CSD,Pepsi,Pull-Non-Working,All Other Non-Working,CP out of pocket admin,0,0,0,0,0,0,0
LAB North,El Salvador,2024,CSD,Pepsi,Pull-Non-Working,All Other Non-Working,Grassroots/experiential out of pocket,0,0,0,0,0,0,0
LAB North,El Salvador,2024,CSD,Pepsi,Pull-Non-Working,All Other Non-Working,League/property- rights fee/options,0,0,0,0,0,0,0
LAB North,El Salvador,2024,CSD,Pepsi,Pull-Non-Working,All Other Non-Working,Market Research,0,0,0,0,0,0,0
LAB North,El Salvador,2024,CSD,Pepsi,Pull-Non-Working,All Other Non-Working,Non-allocated NW,0,0,0,0,0,0,0
LAB North,El Salvador,2024,CSD,Pepsi,Pull-Non-Working,All Other Non-Working,Other Non Working-non itemised talent,0,0,0,0,0,0,0
LAB North,El Salvador,2024,CSD,Pepsi,Pull-Non-Working,All Other Non-Working,PR out of pocket administrative,0,0,0,0,0,0,0
LAB North,El Salvador,2024,CSD,Pepsi,Pull-Non-Working,Innovation and Insight,Innovations,0,0,0,0,0,0,0
LAB North,El Salvador,2024,CSD,Pepsi,Pull-Non-Working,Innovation and Insight,Market Research,0,0,0,0,0,0,0
LAB North,El Salvador,2024,CSD,Pepsi,Pull-Non-Working,Package Design,Package design,0,0,0,0,0,0,0
LAB North,El Salvador,2024,CSD,Pepsi,Pull-Non-Working,Package Design,Package development,0,0,0,0,0,0,0
LAB North,El Salvador,2024,CSD,Pepsi,STB - Push,Capability Building/Other,Capability Building Other,50,116930,61732,55198,116930,61732,55198
LAB North,El Salvador,2024,CSD,Pepsi,STB - Push,Other Investments,CDA's,50,1171415,553884,617531,1171415,553884,617531
LAB North,El Salvador,2024,CSD,Pepsi,STB - Push,Other Investments,Capital (Coolers),0,0,0,0,0,0,0
LAB North,El Salvador,2024,CSD,Pepsi,STB - Push,Other Investments,Price Support,0,0,0,0,0,0,0
LAB North,El Salvador,2024,CSD,Pepsi,STB - Push,Other Investments,Vending / Racks,0,0,0,0,0,0,0
LAB North,El Salvador,2024,CSD,Pepsi,STB - Push,Other Trade,Frozen Funds,0,0,0,0,0,0,0
LAB North,El Salvador,2024,CSD,Pepsi,STB - Push,Other Trade,Other Trade,0,0,0,0,0,0,0
LAB North,El Salvador,2024,CSD,Pepsi,STB - Push,Trade Equipment,Coolers - New,0,0,0,0,0,0,0
LAB North,El Salvador,2024,CSD,Pepsi,STB - Push,Trade Equipment,Coolers - Refurbished,0,0,0,0,0,0,0
LAB North,El Salvador,2024,CSD,Pepsi,STB - Push,Trade Equipment,Post Mix / Pre Mix Equip.,0,0,0,0,0,0,0
LAB North,El Salvador,2024,CSD,Pepsi,STB - Push,Trade Equipment,Vending / Racks,0,0,0,0,0,0,0
LAB North,El Salvador,2024,CSD,Pepsi,STB - Push,Trade Programs,Distribution Incentives,0,0,0,0,0,0,0
LAB North,El Salvador,2024,CSD,Pepsi,STB - Push,Trade Programs,Innovation Investments,0,0,0,0,0,0,0
LAB North,El Salvador,2024,CSD,Pepsi,STB - Push,Trade Programs,Sales Incentives,0,0,0,0,0,0,0
LAB North,El Salvador,2024,CSD,Pepsi,STB - Push,Trade Programs,Space Investments,50,3699054,1876121,1822933,3699054,1876121,1822933
LAB North,El Salvador,2024,CSD,Pepsi,Pull-Working,All Other Working,Other Working - PR execution,0,0,0,0,0,0,0
LAB North,El Salvador,2024,CSD,Pepsi,Pull-Working,All Other Working,Other Working - activation,50,378837,187440,191397,378837,187440,191397
LAB North,El Salvador,2024,CSD,Pepsi,Pull-Working,All Other Working,Other Working - non allocated working,0,0,0,0,0,0,0
LAB North,El Salvador,2024,CSD,Pepsi,Pull-Working,Consumer Promotions,Consumer Promotions Execution,50,56319,27259,29060,56319,27259,29060
LAB North,El Salvador,2024,CSD,Pepsi,Pull-Working,Consumer Promotions,Coupons,50,464330,232875,231455,464330,232875,231455
LAB North,El Salvador,2024,CSD,Pepsi,Pull-Working,Consumer Promotions,Other,0,0,0,0,0,0,0
LAB North,El Salvador,2024,CSD,Pepsi,Pull-Working,Consumer Promotions,Premiums,0,0,0,0,0,0,0
LAB North,El Salvador,2024,CSD,Pepsi,Pull-Working,In Store & POS Execution,In-Store & POS Execution,50,414327,207697,206630,414327,207697,206630
LAB North,El Salvador,2024,CSD,Pepsi,Pull-Working,Media Placements,Cinema,0,0,0,0,0,0,0
LAB North,El Salvador,2024,CSD,Pepsi,Pull-Working,Media Placements,Digital,50,766704,388674,378030,766704,388674,378030
LAB North,El Salvador,2024,CSD,Pepsi,Pull-Working,Media Placements,OOH - Out Of Home,50,333303,166476,166827,333303,166476,166827
LAB North,El Salvador,2024,CSD,Pepsi,Pull-Working,Media Placements,Other,0,0,0,0,0,0,0
LAB North,El Salvador,2024,CSD,Pepsi,Pull-Working,Media Placements,Print,0,0,0,0,0,0,0
LAB North,El Salvador,2024,CSD,Pepsi,Pull-Working,Media Placements,Radio,50,14882,7282,7600,14882,7282,7600
LAB North,El Salvador,2024,CSD,Pepsi,Pull-Working,Media Placements,TV,50,349996,180053,169943,349996,180053,169943
LAB North,El Salvador,2024,CSD,Pepsi,Pull-Working,Sampling,Product Samples,0,0,0,0,0,0,0
LAB North,El Salvador,2024,CSD,Pepsi,Pull-Working,Sampling,Sampling Execution,0,0,0,0,0,0,0
LAB North,El Salvador,2024,CSD,Pepsi,Pull-Working,Sponsorships,Sponsorships-in game/ in show,0,0,0,0,0,0,0
LAB North,El Salvador,2024,CSD,Pepsi,Pull-Working,Sponsorships,Sports-athlete/team contracts,0,0,0,0,0,0,0
LAB North,El Salvador,2024,CSD,Pepsi,Pull-Working,Sponsorships,Sports-on field or in show props,0,0,0,0,0,0,0
LAB North,El Salvador,2024,CSD,Pepsi,Pull-Working,Sponsorships,Sports-stadium contracts,0,0,0,0,0,0,0
LAB North,Guatemala,2024,Energy Drinks,AMP,Pull-Non-Working,Ad Production,Digital Ad Production,0,0,0,0,0,0,0
LAB North,Guatemala,2024,Energy Drinks,AMP,Pull-Non-Working,Ad Production,"TV, Print, Radio, OOH, Production",50,146665,73301,73364,18826,9409,9417
LAB North,Guatemala,2024,Energy Drinks,AMP,Pull-Non-Working,Agency Fees,Creative Agency Fees,0,0,0,0,0,0,0
LAB North,Guatemala,2024,Energy Drinks,AMP,Pull-Non-Working,Agency Fees,In Store & POS Design / Development,0,0,0,0,0,0,0
LAB North,Guatemala,2024,Energy Drinks,AMP,Pull-Non-Working,Agency Fees,Media Agency Fees,0,0,0,0,0,0,0
LAB North,Guatemala,2024,Energy Drinks,AMP,Pull-Non-Working,Agency Fees,Other,0,0,0,0,0,0,0
LAB North,Guatemala,2024,Energy Drinks,AMP,Pull-Non-Working,Agency Fees,Social Media / Influence Marketing,0,0,0,0,0,0,0
LAB North,Guatemala,2024,Energy Drinks,AMP,Pull-Non-Working,All Other Non-Working,Administrative fees,0,0,0,0,0,0,0
LAB North,Guatemala,2024,Energy Drinks,AMP,Pull-Non-Working,All Other Non-Working,Agency out of pocket,0,0,0,0,0,0,0
LAB North,Guatemala,2024,Energy Drinks,AMP,Pull-Non-Working,All Other Non-Working,CP out of pocket admin,0,0,0,0,0,0,0
LAB North,Guatemala,2024,Energy Drinks,AMP,Pull-Non-Working,All Other Non-Working,Grassroots/experiential out of pocket,0,0,0,0,0,0,0
LAB North,Guatemala,2024,Energy Drinks,AMP,Pull-Non-Working,All Other Non-Working,League/property- rights fee/options,0,0,0,0,0,0,0
LAB North,Guatemala,2024,Energy Drinks,AMP,Pull-Non-Working,All Other Non-Working,Market Research,0,0,0,0,0,0,0
LAB North,Guatemala,2024,Energy Drinks,AMP,Pull-Non-Working,All Other Non-Working,Non-allocated NW,0,0,0,0,0,0,0
LAB North,Guatemala,2024,Energy Drinks,AMP,Pull-Non-Working,All Other Non-Working,Other Non Working-non itemised talent,0,0,0,0,0,0,0
LAB North,Guatemala,2024,Energy Drinks,AMP,Pull-Non-Working,All Other Non-Working,PR out of pocket administrative,0,0,0,0,0,0,0
LAB North,Guatemala,2024,Energy Drinks,AMP,Pull-Non-Working,Innovation and Insight,Innovations,0,0,0,0,0,0,0
LAB North,Guatemala,2024,Energy Drinks,AMP,Pull-Non-Working,Innovation and Insight,Market Research,50,370489,176212,194277,47556,22619,24937
LAB North,Guatemala,2024,Energy Drinks,AMP,Pull-Non-Working,Package Design,Package design,0,0,0,0,0,0,0
LAB North,Guatemala,2024,Energy Drinks,AMP,Pull-Non-Working,Package Design,Package development,0,0,0,0,0,0,0
LAB North,Guatemala,2024,Energy Drinks,AMP,STB - Push,Capability Building/Other,Capability Building Other,0,0,0,0,0,0,0
LAB North,Guatemala,2024,Energy Drinks,AMP,STB - Push,Other Investments,CDA's,0,0,0,0,0,0,0
LAB North,Guatemala,2024,Energy Drinks,AMP,STB - Push,Other Investments,Capital (Coolers),0,0,0,0,0,0,0
LAB North,Guatemala,2024,Energy Drinks,AMP,STB - Push,Other Investments,Price Support,50,8021242,3961180,4060062,1029627,508467,521160
LAB North,Guatemala,2024,Energy Drinks,AMP,STB - Push,Other Investments,Vending / Racks,0,0,0,0,0,0,0
LAB North,Guatemala,2024,Energy Drinks,AMP,STB - Push,Other Trade,Frozen Funds,0,0,0,0,0,0,0
LAB North,Guatemala,2024,Energy Drinks,AMP,STB - Push,Other Trade,Other Trade,0,0,0,0,0,0,0
LAB North,Guatemala,2024,Energy Drinks,AMP,STB - Push,Trade Equipment,Coolers - New,50,1634575,819253,815322,209818,105161,104657
LAB North,Guatemala,2024,Energy Drinks,AMP,STB - Push,Trade Equipment,Coolers - Refurbished,50,206934,102466,104468,26562,13152,13410
LAB North,Guatemala,2024,Energy Drinks,AMP,STB - Push,Trade Equipment,Post Mix / Pre Mix Equip.,0,0,0,0,0,0,0
LAB North,Guatemala,2024,Energy Drinks,AMP,STB - Push,Trade Equipment,Vending / Racks,50,219043,111129,107914,28116,14264,13852
LAB North,Guatemala,2024,Energy Drinks,AMP,STB - Push,Trade Programs,Distribution Incentives,50,110849,54177,56672,14228,6954,7274
LAB North,Guatemala,2024,Energy Drinks,AMP,STB - Push,Trade Programs,Innovation Investments,0,0,0,0,0,0,0
LAB North,Guatemala,2024,Energy Drinks,AMP,STB - Push,Trade Programs,Sales Incentives,50,7276,3739,3537,933,479,454
LAB North,Guatemala,2024,Energy Drinks,AMP,STB - Push,Trade Programs,Space Investments,50,505250,260482,244768,64855,33436,31419
LAB North,Guatemala,2024,Energy Drinks,AMP,Pull-Working,All Other Working,Other Working - PR execution,0,0,0,0,0,0,0
LAB North,Guatemala,2024,Energy Drinks,AMP,Pull-Working,All Other Working,Other Working - activation,0,0,0,0,0,0,0
LAB North,Guatemala,2024,Energy Drinks,AMP,Pull-Working,All Other Working,Other Working - non allocated working,0,0,0,0,0,0,0
LAB North,Guatemala,2024,Energy Drinks,AMP,Pull-Working,Consumer Promotions,Consumer Promotions Execution,50,271040,134399,136641,34791,17251,17540
LAB North,Guatemala,2024,Energy Drinks,AMP,Pull-Working,Consumer Promotions,Coupons,0,0,0,0,0,0,0
LAB North,Guatemala,2024,Energy Drinks,AMP,Pull-Working,Consumer Promotions,Other,0,0,0,0,0,0,0
LAB North,Guatemala,2024,Energy Drinks,AMP,Pull-Working,Consumer Promotions,Premiums,50,36245,17477,18768,4652,2243,2409
LAB North,Guatemala,2024,Energy Drinks,AMP,Pull-Working,In Store & POS Execution,In-Store & POS Execution,50,881839,440384,441455,113195,56528,56667
LAB North,Guatemala,2024,Energy Drinks,AMP,Pull-Working,Media Placements,Cinema,0,0,0,0,0,0,0
LAB North,Guatemala,2024,Energy Drinks,AMP,Pull-Working,Media Placements,Digital,50,671214,339936,331278,86158,43635,42523
LAB North,Guatemala,2024,Energy Drinks,AMP,Pull-Working,Media Placements,OOH - Out Of Home,50,796652,383407,413245,102260,49215,53045
LAB North,Guatemala,2024,Energy Drinks,AMP,Pull-Working,Media Placements,Other,0,0,0,0,0,0,0
LAB North,Guatemala,2024,Energy Drinks,AMP,Pull-Working,Media Placements,Print,50,35843,17571,18272,4600,2255,2345
LAB North,Guatemala,2024,Energy Drinks,AMP,Pull-Working,Media Placements,Radio,50,421539,212533,209006,54109,27281,26828
LAB North,Guatemala,2024,Energy Drinks,AMP,Pull-Working,Media Placements,TV,50,722025,364937,357088,92681,46844,45837
LAB North,Guatemala,2024,Energy Drinks,AMP,Pull-Working,Sampling,Product Samples,0,0,0,0,0,0,0
LAB North,Guatemala,2024,Energy Drinks,AMP,Pull-Working,Sampling,Sampling Execution,0,0,0,0,0,0,0
LAB North,Guatemala,2024,Energy Drinks,AMP,Pull-Working,Sponsorships,Sponsorships-in game/ in show,50,91862,47133,44729,11791,6050,5741
LAB North,Guatemala,2024,Energy Drinks,AMP,Pull-Working,Sponsorships,Sports-athlete/team contracts,0,0,0,0,0,0,0
LAB North,Guatemala,2024,Energy Drinks,AMP,Pull-Working,Sponsorships,Sports-on field or in show props,0,0,0,0,0,0,0
LAB North,Guatemala,2024,Energy Drinks,AMP,Pull-Working,Sponsorships,Sports-stadium contracts,0,0,0,0,0,0,0
LAB North,Guatemala,2024,Energy Drinks,Adrenaline,Pull-Non-Working,Ad Production,Digital Ad Production,0,0,0,0,0,0,0
LAB North,Guatemala,2024,Energy Drinks,Adrenaline,Pull-Non-Working,Ad Production,"TV, Print, Radio, OOH, Production",50,383212,189515,193697,49190,24326,24864
LAB North,Guatemala,2024,Energy Drinks,Adrenaline,Pull-Non-Working,Agency Fees,Creative Agency Fees,0,0,0,0,0,0,0
LAB North,Guatemala,2024,Energy Drinks,Adrenaline,Pull-Non-Working,Agency Fees,In Store & POS Design / Development,0,0,0,0,0,0,0
LAB North,Guatemala,2024,Energy Drinks,Adrenaline,Pull-Non-Working,Agency Fees,Media Agency Fees,0,0,0,0,0,0,0
LAB North,Guatemala,2024,Energy Drinks,Adrenaline,Pull-Non-Working,Agency Fees,Other,0,0,0,0,0,0,0
LAB North,Guatemala,2024,Energy Drinks,Adrenaline,Pull-Non-Working,Agency Fees,Social Media / Influence Marketing,0,0,0,0,0,0,0
LAB North,Guatemala,2024,Energy Drinks,Adrenaline,Pull-Non-Working,All Other Non-Working,Administrative fees,0,0,0,0,0,0,0
LAB North,Guatemala,2024,Energy Drinks,Adrenaline,Pull-Non-Working,All Other Non-Working,Agency out of pocket,0,0,0,0,0,0,0
LAB North,Guatemala,2024,Energy Drinks,Adrenaline,Pull-Non-Working,All Other Non-Working,CP out of pocket admin,0,0,0,0,0,0,0
LAB North,Guatemala,2024,Energy Drinks,Adrenaline,Pull-Non-Working,All Other Non-Working,Grassroots/experiential out of pocket,0,0,0,0,0,0,0
LAB North,Guatemala,2024,Energy Drinks,Adrenaline,Pull-Non-Working,All Other Non-Working,League/property- rights fee/options,0,0,0,0,0,0,0
LAB North,Guatemala,2024,Energy Drinks,Adrenaline,Pull-Non-Working,All Other Non-Working,Market Research,0,0,0,0,0,0,0
LAB North,Guatemala,2024,Energy Drinks,Adrenaline,Pull-Non-Working,All Other Non-Working,Non-allocated NW,0,0,0,0,0,0,0
LAB North,Guatemala,2024,Energy Drinks,Adrenaline,Pull-Non-Working,All Other Non-Working,Other Non Working-non itemised talent,0,0,0,0,0,0,0
LAB North,Guatemala,2024,Energy Drinks,Adrenaline,Pull-Non-Working,All Other Non-Working,PR out of pocket administrative,0,0,0,0,0,0,0
LAB North,Guatemala,2024,Energy Drinks,Adrenaline,Pull-Non-Working,Innovation and Insight,Innovations,0,0,0,0,0,0,0
LAB North,Guatemala,2024,Energy Drinks,Adrenaline,Pull-Non-Working,Innovation and Insight,Market Research,50,361667,186780,174887,46424,23975,22449
LAB North,Guatemala,2024,Energy Drinks,Adrenaline,Pull-Non-Working,Package Design,Package design,0,0,0,0,0,0,0
LAB North,Guatemala,2024,Energy Drinks,Adrenaline,Pull-Non-Working,Package Design,Package development,0,0,0,0,0,0,0
LAB North,Guatemala,2024,Energy Drinks,Adrenaline,STB - Push,Capability Building/Other,Capability Building Other,0,0,0,0,0,0,0
LAB North,Guatemala,2024,Energy Drinks,Adrenaline,STB - Push,Other Investments,CDA's,0,0,0,0,0,0,0
LAB North,Guatemala,2024,Energy Drinks,Adrenaline,STB - Push,Other Investments,Capital (Coolers),0,0,0,0,0,0,0
LAB North,Guatemala,2024,Energy Drinks,Adrenaline,STB - Push,Other Investments,Price Support,50,19967221,9560657,10406564,2563044,1227231,1335813
LAB North,Guatemala,2024,Energy Drinks,Adrenaline,STB - Push,Other Investments,Vending / Racks,0,0,0,0,0,0,0
LAB North,Guatemala,2024,Energy Drinks,Adrenaline,STB - Push,Other Trade,Frozen Funds,0,0,0,0,0,0,0
LAB North,Guatemala,2024,Energy Drinks,Adrenaline,STB - Push,Other Trade,Other Trade,0,0,0,0,0,0,0
LAB North,Guatemala,2024,Energy Drinks,Adrenaline,STB - Push,Trade Equipment,Coolers - New,50,7325412,3481506,3843906,940309,446895,493414
LAB North,Guatemala,2024,Energy Drinks,Adrenaline,STB - Push,Trade Equipment,Coolers - Refurbished,50,890080,451022,439058,114253,57894,56359
LAB North,Guatemala,2024,Energy Drinks,Adrenaline,STB - Push,Trade Equipment,Post Mix / Pre Mix Equip.,0,0,0,0,0,0,0
LAB North,Guatemala,2024,Energy Drinks,Adrenaline,STB - Push,Trade Equipment,Vending / Racks,50,210663,107098,103565,27041,13747,13294
LAB North,Guatemala,2024,Energy Drinks,Adrenaline,STB - Push,Trade Programs,Distribution Incentives,50,247120,129281,117839,31720,16594,15126
LAB North,Guatemala,2024,Energy Drinks,Adrenaline,STB - Push,Trade Programs,Innovation Investments,0,0,0,0,0,0,0
LAB North,Guatemala,2024,Energy Drinks,Adrenaline,STB - Push,Trade Programs,Sales Incentives,50,14589,7286,7303,1872,935,937
LAB North,Guatemala,2024,Energy Drinks,Adrenaline,STB - Push,Trade Programs,Space Investments,50,364282,181922,182360,46760,23351,23409
LAB North,Guatemala,2024,Energy Drinks,Adrenaline,Pull-Working,All Other Working,Other Working - PR execution,0,0,0,0,0,0,0
LAB North,Guatemala,2024,Energy Drinks,Adrenaline,Pull-Working,All Other Working,Other Working - activation,0,0,0,0,0,0,0
LAB North,Guatemala,2024,Energy Drinks,Adrenaline,Pull-Working,All Other Working,Other Working - non allocated working,0,0,0,0,0,0,0
LAB North,Guatemala,2024,Energy Drinks,Adrenaline,Pull-Working,Consumer Promotions,Consumer Promotions Execution,50,727416,372813,354603,93373,47855,45518
LAB North,Guatemala,2024,Energy Drinks,Adrenaline,Pull-Working,Consumer Promotions,Coupons,0,0,0,0,0,0,0
LAB North,Guatemala,2024,Energy Drinks,Adrenaline,Pull-Working,Consumer Promotions,Other,0,0,0,0,0,0,0
LAB North,Guatemala,2024,Energy Drinks,Adrenaline,Pull-Working,Consumer Promotions,Premiums,50,18507,9182,9325,2375,1178,1197
LAB North,Guatemala,2024,Energy Drinks,Adrenaline,Pull-Working,In Store & POS Execution,In-Store & POS Execution,50,931065,471196,459869,119513,60483,59030
LAB North,Guatemala,2024,Energy Drinks,Adrenaline,Pull-Working,Media Placements,Cinema,0,0,0,0,0,0,0
LAB North,Guatemala,2024,Energy Drinks,Adrenaline,Pull-Working,Media Placements,Digital,50,422245,206142,216103,54200,26460,27740
LAB North,Guatemala,2024,Energy Drinks,Adrenaline,Pull-Working,Media Placements,OOH - Out Of Home,50,111790,58268,53522,14349,7479,6870
LAB North,Guatemala,2024,Energy Drinks,Adrenaline,Pull-Working,Media Placements,Other,0,0,0,0,0,0,0
LAB North,Guatemala,2024,Energy Drinks,Adrenaline,Pull-Working,Media Placements,Print,0,0,0,0,0,0,0
LAB North,Guatemala,2024,Energy Drinks,Adrenaline,Pull-Working,Media Placements,Radio,0,0,0,0,0,0,0
LAB North,Guatemala,2024,Energy Drinks,Adrenaline,Pull-Working,Media Placements,TV,0,0,0,0,0,0,0
LAB North,Guatemala,2024,Energy Drinks,Adrenaline,Pull-Working,Sampling,Product Samples,0,0,0,0,0,0,0
LAB North,Guatemala,2024,Energy Drinks,Adrenaline,Pull-Working,Sampling,Sampling Execution,0,0,0,0,0,0,0
LAB North,Guatemala,2024,Energy Drinks,Adrenaline,Pull-Working,Sponsorships,Sponsorships-in game/ in show,50,131498,63941,67557,16879,8207,8672
LAB North,Guatemala,2024,Energy Drinks,Adrenaline,Pull-Working,Sponsorships,Sports-athlete/team contracts,50,18167,8882,9285,2331,1140,1191
LAB North,Guatemala,2024,Energy Drinks,Adrenaline,Pull-Working,Sponsorships,Sports-on field or in show props,0,0,0,0,0,0,0
LAB North,Guatemala,2024,Energy Drinks,Adrenaline,Pull-Working,Sponsorships,Sports-stadium contracts,0,0,0,0,0,0,0
LAB North,Guatemala,2024,Sport Drinks,Gatorade,Pull-Non-Working,Ad Production,Digital Ad Production,0,0,0,0,0,0,0
LAB North,Guatemala,2024,Sport Drinks,Gatorade,Pull-Non-Working,Ad Production,"TV, Print, Radio, OOH, Production",50,436546,220440,216106,56036,28296,27740
LAB North,Guatemala,2024,Sport Drinks,Gatorade,Pull-Non-Working,Agency Fees,Creative Agency Fees,0,0,0,0,0,0,0
LAB North,Guatemala,2024,Sport Drinks,Gatorade,Pull-Non-Working,Agency Fees,In Store & POS Design / Development,0,0,0,0,0,0,0
LAB North,Guatemala,2024,Sport Drinks,Gatorade,Pull-Non-Working,Agency Fees,Media Agency Fees,0,0,0,0,0,0,0
LAB North,Guatemala,2024,Sport Drinks,Gatorade,Pull-Non-Working,Agency Fees,Other,0,0,0,0,0,0,0
LAB North,Guatemala,2024,Sport Drinks,Gatorade,Pull-Non-Working,Agency Fees,Social Media / Influence Marketing,0,0,0,0,0,0,0
LAB North,Guatemala,2024,Sport Drinks,Gatorade,Pull-Non-Working,All Other Non-Working,Administrative fees,0,0,0,0,0,0,0
LAB North,Guatemala,2024,Sport Drinks,Gatorade,Pull-Non-Working,All Other Non-Working,Agency out of pocket,0,0,0,0,0,0,0
LAB North,Guatemala,2024,Sport Drinks,Gatorade,Pull-Non-Working,All Other Non-Working,CP out of pocket admin,0,0,0,0,0,0,0
LAB North,Guatemala,2024,Sport Drinks,Gatorade,Pull-Non-Working,All Other Non-Working,Grassroots/experiential out of pocket,0,0,0,0,0,0,0
LAB North,Guatemala,2024,Sport Drinks,Gatorade,Pull-Non-Working,All Other Non-Working,League/property- rights fee/options,0,0,0,0,0,0,0
LAB North,Guatemala,2024,Sport Drinks,Gatorade,Pull-Non-Working,All Other Non-Working,Market Research,0,0,0,0,0,0,0
LAB North,Guatemala,2024,Sport Drinks,Gatorade,Pull-Non-Working,All Other Non-Working,Non-allocated NW,0,0,0,0,0,0,0
LAB North,Guatemala,2024,Sport Drinks,Gatorade,Pull-Non-Working,All Other Non-Working,Other Non Working-non itemised talent,0,0,0,0,0,0,0
LAB North,Guatemala,2024,Sport Drinks,Gatorade,Pull-Non-Working,All Other Non-Working,PR out of pocket administrative,0,0,0,0,0,0,0
LAB North,Guatemala,2024,Sport Drinks,Gatorade,Pull-Non-Working,Innovation and Insight,Innovations,0,0,0,0,0,0,0
LAB North,Guatemala,2024,Sport Drinks,Gatorade,Pull-Non-Working,Innovation and Insight,Market Research,50,711200,345358,365842,91291,44331,46960
LAB North,Guatemala,2024,Sport Drinks,Gatorade,Pull-Non-Working,Package Design,Package design,0,0,0,0,0,0,0
LAB North,Guatemala,2024,Sport Drinks,Gatorade,Pull-Non-Working,Package Design,Package development,0,0,0,0,0,0,0
LAB North,Guatemala,2024,Sport Drinks,Gatorade,STB - Push,Capability Building/Other,Capability Building Other,0,0,0,0,0,0,0
LAB North,Guatemala,2024,Sport Drinks,Gatorade,STB - Push,Other Investments,CDA's,50,908774,442798,465976,116652,56838,59814
LAB North,Guatemala,2024,Sport Drinks,Gatorade,STB - Push,Other Investments,Capital (Coolers),0,0,0,0,0,0,0
LAB North,Guatemala,2024,Sport Drinks,Gatorade,STB - Push,Other Investments,Price Support,50,11858744,5728230,6130514,1522219,735290,786929
LAB North,Guatemala,2024,Sport Drinks,Gatorade,STB - Push,Other Investments,Vending / Racks,0,0,0,0,0,0,0
LAB North,Guatemala,2024,Sport Drinks,Gatorade,STB - Push,Other Trade,Frozen Funds,0,0,0,0,0,0,0
LAB North,Guatemala,2024,Sport Drinks,Gatorade,STB - Push,Other Trade,Other Trade,0,0,0,0,0,0,0
LAB North,Guatemala,2024,Sport Drinks,Gatorade,STB - Push,Trade Equipment,Coolers - New,50,13669774,6861463,6808311,1754688,880755,873933
LAB North,Guatemala,2024,Sport Drinks,Gatorade,STB - Push,Trade Equipment,Coolers - Refurbished,50,1685297,888448,796849,216329,114043,102286
LAB North,Guatemala,2024,Sport Drinks,Gatorade,STB - Push,Trade Equipment,Post Mix / Pre Mix Equip.,0,0,0,0,0,0,0
LAB North,Guatemala,2024,Sport Drinks,Gatorade,STB - Push,Trade Equipment,Vending / Racks,50,216051,106969,109082,27732,13730,14002
LAB North,Guatemala,2024,Sport Drinks,Gatorade,STB - Push,Trade Programs,Distribution Incentives,50,567917,285341,282576,72899,36627,36272
LAB North,Guatemala,2024,Sport Drinks,Gatorade,STB - Push,Trade Programs,Innovation Investments,0,0,0,0,0,0,0
LAB North,Guatemala,2024,Sport Drinks,Gatorade,STB - Push,Trade Programs,Sales Incentives,50,90400,44744,45656,11603,5743,5860
LAB North,Guatemala,2024,Sport Drinks,Gatorade,STB - Push,Trade Programs,Space Investments,50,1317669,676767,640902,169139,86871,82268
LAB North,Guatemala,2024,Sport Drinks,Gatorade,Pull-Working,All Other Working,Other Working - PR execution,0,0,0,0,0,0,0
LAB North,Guatemala,2024,Sport Drinks,Gatorade,Pull-Working,All Other Working,Other Working - activation,0,0,0,0,0,0,0
LAB North,Guatemala,2024,Sport Drinks,Gatorade,Pull-Working,All Other Working,Other Working - non allocated working,0,0,0,0,0,0,0
LAB North,Guatemala,2024,Sport Drinks,Gatorade,Pull-Working,Consumer Promotions,Consumer Promotions Execution,50,3041462,1551317,1490145,390410,199131,191279
LAB North,Guatemala,2024,Sport Drinks,Gatorade,Pull-Working,Consumer Promotions,Coupons,0,0,0,0,0,0,0
LAB North,Guatemala,2024,Sport Drinks,Gatorade,Pull-Working,Consumer Promotions,Other,0,0,0,0,0,0,0
LAB North,Guatemala,2024,Sport Drinks,Gatorade,Pull-Working,Consumer Promotions,Premiums,50,181778,93120,88658,23333,11953,11380
LAB North,Guatemala,2024,Sport Drinks,Gatorade,Pull-Working,In Store & POS Execution,In-Store & POS Execution,50,3177971,1574100,1603871,407932,202055,205877
LAB North,Guatemala,2024,Sport Drinks,Gatorade,Pull-Working,Media Placements,Cinema,0,0,0,0,0,0,0
LAB North,Guatemala,2024,Sport Drinks,Gatorade,Pull-Working,Media Placements,Digital,50,712205,353522,358683,91420,45379,46041
LAB North,Guatemala,2024,Sport Drinks,Gatorade,Pull-Working,Media Placements,OOH - Out Of Home,0,0,0,0,0,0,0
LAB North,Guatemala,2024,Sport Drinks,Gatorade,Pull-Working,Media Placements,Other,0,0,0,0,0,0,0
LAB North,Guatemala,2024,Sport Drinks,Gatorade,Pull-Working,Media Placements,Print,0,0,0,0,0,0,0
LAB North,Guatemala,2024,Sport Drinks,Gatorade,Pull-Working,Media Placements,Radio,0,0,0,0,0,0,0
LAB North,Guatemala,2024,Sport Drinks,Gatorade,Pull-Working,Media Placements,TV,0,0,0,0,0,0,0
LAB North,Guatemala,2024,Sport Drinks,Gatorade,Pull-Working,Sampling,Product Samples,0,0,0,0,0,0,0
LAB North,Guatemala,2024,Sport Drinks,Gatorade,Pull-Working,Sampling,Sampling Execution,50,415323,203333,211990,53311,26100,27211
LAB North,Guatemala,2024,Sport Drinks,Gatorade,Pull-Working,Sponsorships,Sponsorships-in game/ in show,50,1069404,523196,546208,137271,67158,70113
LAB North,Guatemala,2024,Sport Drinks,Gatorade,Pull-Working,Sponsorships,Sports-athlete/team contracts,50,860074,455108,404966,110401,58418,51983
LAB North,Guatemala,2024,Sport Drinks,Gatorade,Pull-Working,Sponsorships,Sports-on field or in show props,0,0,0,0,0,0,0
LAB North,Guatemala,2024,Sport Drinks,Gatorade,Pull-Working,Sponsorships,Sports-stadium contracts,0,0,0,0,0,0,0
LAB North,Guatemala,2024,RTD Tea,Lipton,Pull-Non-Working,Ad Production,Digital Ad Production,0,0,0,0,0,0,0
LAB North,Guatemala,2024,RTD Tea,Lipton,Pull-Non-Working,Ad Production,"TV, Print, Radio, OOH, Production",50,78265,41024,37241,10046,5265,4781
LAB North,Guatemala,2024,RTD Tea,Lipton,Pull-Non-Working,Agency Fees,Creative Agency Fees,0,0,0,0,0,0,0
LAB North,Guatemala,2024,RTD Tea,Lipton,Pull-Non-Working,Agency Fees,In Store & POS Design / Development,0,0,0,0,0,0,0
LAB North,Guatemala,2024,RTD Tea,Lipton,Pull-Non-Working,Agency Fees,Media Agency Fees,0,0,0,0,0,0,0
LAB North,Guatemala,2024,RTD Tea,Lipton,Pull-Non-Working,Agency Fees,Other,0,0,0,0,0,0,0
LAB North,Guatemala,2024,RTD Tea,Lipton,Pull-Non-Working,Agency Fees,Social Media / Influence Marketing,0,0,0,0,0,0,0
LAB North,Guatemala,2024,RTD Tea,Lipton,Pull-Non-Working,All Other Non-Working,Administrative fees,0,0,0,0,0,0,0
LAB North,Guatemala,2024,RTD Tea,Lipton,Pull-Non-Working,All Other Non-Working,Agency out of pocket,0,0,0,0,0,0,0
LAB North,Guatemala,2024,RTD Tea,Lipton,Pull-Non-Working,All Other Non-Working,CP out of pocket admin,0,0,0,0,0,0,0
LAB North,Guatemala,2024,RTD Tea,Lipton,Pull-Non-Working,All Other Non-Working,Grassroots/experiential out of pocket,0,0,0,0,0,0,0
LAB North,Guatemala,2024,RTD Tea,Lipton,Pull-Non-Working,All Other Non-Working,League/property- rights fee/options,0,0,0,0,0,0,0
LAB North,Guatemala,2024,RTD Tea,Lipton,Pull-Non-Working,All Other Non-Working,Market Research,0,0,0,0,0,0,0
LAB North,Guatemala,2024,RTD Tea,Lipton,Pull-Non-Working,All Other Non-Working,Non-allocated NW,0,0,0,0,0,0,0
LAB North,Guatemala,2024,RTD Tea,Lipton,Pull-Non-Working,All Other Non-Working,Other Non Working-non itemised talent,0,0,0,0,0,0,0
LAB North,Guatemala,2024,RTD Tea,Lipton,Pull-Non-Working,All Other Non-Working,PR out of pocket administrative,0,0,0,0,0,0,0
LAB North,Guatemala,2024,RTD Tea,Lipton,Pull-Non-Working,Innovation and Insight,Innovations,0,0,0,0,0,0,0
LAB North,Guatemala,2024,RTD Tea,Lipton,Pull-Non-Working,Innovation and Insight,Market Research,50,223234,106984,116250,28654,13732,14922
LAB North,Guatemala,2024,RTD Tea,Lipton,Pull-Non-Working,Package Design,Package design,0,0,0,0,0,0,0
LAB North,Guatemala,2024,RTD Tea,Lipton,Pull-Non-Working,Package Design,Package development,0,0,0,0,0,0,0
LAB North,Guatemala,2024,RTD Tea,Lipton,STB - Push,Capability Building/Other,Capability Building Other,0,0,0,0,0,0,0
LAB North,Guatemala,2024,RTD Tea,Lipton,STB - Push,Other Investments,CDA's,50,1567773,757164,810609,201243,97191,104052
LAB North,Guatemala,2024,RTD Tea,Lipton,STB - Push,Other Investments,Capital (Coolers),0,0,0,0,0,0,0
LAB North,Guatemala,2024,RTD Tea,Lipton,STB - Push,Other Investments,Price Support,50,2771238,1356846,1414392,355723,174168,181555
LAB North,Guatemala,2024,RTD Tea,Lipton,STB - Push,Other Investments,Vending / Racks,0,0,0,0,0,0,0
LAB North,Guatemala,2024,RTD Tea,Lipton,STB - Push,Other Trade,Frozen Funds,0,0,0,0,0,0,0
LAB North,Guatemala,2024,RTD Tea,Lipton,STB - Push,Other Trade,Other Trade,0,0,0,0,0,0,0
LAB North,Guatemala,2024,RTD Tea,Lipton,STB - Push,Trade Equipment,Coolers - New,50,3229036,1591591,1637445,414487,204300,210187
LAB North,Guatemala,2024,RTD Tea,Lipton,STB - Push,Trade Equipment,Coolers - Refurbished,50,404624,201043,203581,51938,25806,26132
LAB North,Guatemala,2024,RTD Tea,Lipton,STB - Push,Trade Equipment,Post Mix / Pre Mix Equip.,50,410263,195672,214591,52662,25116,27546
LAB North,Guatemala,2024,RTD Tea,Lipton,STB - Push,Trade Equipment,Vending / Racks,50,73761,36080,37681,9468,4631,4837
LAB North,Guatemala,2024,RTD Tea,Lipton,STB - Push,Trade Programs,Distribution Incentives,50,492087,248240,243847,63165,31864,31301
LAB North,Guatemala,2024,RTD Tea,Lipton,STB - Push,Trade Programs,Innovation Investments,0,0,0,0,0,0,0
LAB North,Guatemala,2024,RTD Tea,Lipton,STB - Push,Trade Programs,Sales Incentives,50,7205,3585,3620,924,460,464
LAB North,Guatemala,2024,RTD Tea,Lipton,STB - Push,Trade Programs,Space Investments,50,505430,255515,249915,64878,32798,32080
LAB North,Guatemala,2024,RTD Tea,Lipton,Pull-Working,All Other Working,Other Working - PR execution,0,0,0,0,0,0,0
LAB North,Guatemala,2024,RTD Tea,Lipton,Pull-Working,All Other Working,Other Working - activation,0,0,0,0,0,0,0
LAB North,Guatemala,2024,RTD Tea,Lipton,Pull-Working,All Other Working,Other Working - non allocated working,0,0,0,0,0,0,0
LAB North,Guatemala,2024,RTD Tea,Lipton,Pull-Working,Consumer Promotions,Consumer Promotions Execution,50,1665635,837009,828626,213805,107440,106365
LAB North,Guatemala,2024,RTD Tea,Lipton,Pull-Working,Consumer Promotions,Coupons,0,0,0,0,0,0,0
LAB North,Guatemala,2024,RTD Tea,Lipton,Pull-Working,Consumer Promotions,Other,0,0,0,0,0,0,0
LAB North,Guatemala,2024,RTD Tea,Lipton,Pull-Working,Consumer Promotions,Premiums,0,0,0,0,0,0,0
LAB North,Guatemala,2024,RTD Tea,Lipton,Pull-Working,In Store & POS Execution,In-Store & POS Execution,50,4498745,2211814,2286931,577470,283914,293556
LAB North,Guatemala,2024,RTD Tea,Lipton,Pull-Working,Media Placements,Cinema,0,0,0,0,0,0,0
LAB North,Guatemala,2024,RTD Tea,Lipton,Pull-Working,Media Placements,Digital,50,459785,228628,231157,59019,29347,29672
LAB North,Guatemala,2024,RTD Tea,Lipton,Pull-Working,Media Placements,OOH - Out Of Home,0,0,0,0,0,0,0
LAB North,Guatemala,2024,RTD Tea,Lipton,Pull-Working,Media Placements,Other,0,0,0,0,0,0,0
LAB North,Guatemala,2024,RTD Tea,Lipton,Pull-Working,Media Placements,Print,0,0,0,0,0,0,0
LAB North,Guatemala,2024,RTD Tea,Lipton,Pull-Working,Media Placements,Radio,0,0,0,0,0,0,0
LAB North,Guatemala,2024,RTD Tea,Lipton,Pull-Working,Media Placements,TV,0,0,0,0,0,0,0
LAB North,Guatemala,2024,RTD Tea,Lipton,Pull-Working,Sampling,Product Samples,0,0,0,0,0,0,0
LAB North,Guatemala,2024,RTD Tea,Lipton,Pull-Working,Sampling,Sampling Execution,0,0,0,0,0,0,0
LAB North,Guatemala,2024,RTD Tea,Lipton,Pull-Working,Sponsorships,Sponsorships-in game/ in show,50,204355,101876,102479,26231,13077,13154
LAB North,Guatemala,2024,RTD Tea,Lipton,Pull-Working,Sponsorships,Sports-athlete/team contracts,0,0,0,0,0,0,0
LAB North,Guatemala,2024,RTD Tea,Lipton,Pull-Working,Sponsorships,Sports-on field or in show props,0,0,0,0,0,0,0
LAB North,Guatemala,2024,RTD Tea,Lipton,Pull-Working,Sponsorships,Sports-stadium contracts,0,0,0,0,0,0,0
LAB North,Guatemala,2024,CSD,Pepsi,Pull-Non-Working,Ad Production,Digital Ad Production,0,0,0,0,0,0,0
LAB North,Guatemala,2024,CSD,Pepsi,Pull-Non-Working,Ad Production,"TV, Print, Radio, OOH, Production",50,1803289,884284,919005,231474,113509,117965
LAB North,Guatemala,2024,CSD,Pepsi,Pull-Non-Working,Agency Fees,Creative Agency Fees,0,0,0,0,0,0,0
LAB North,Guatemala,2024,CSD,Pepsi,Pull-Non-Working,Agency Fees,In Store & POS Design / Development,0,0,0,0,0,0,0
LAB North,Guatemala,2024,CSD,Pepsi,Pull-Non-Working,Agency Fees,Media Agency Fees,0,0,0,0,0,0,0
LAB North,Guatemala,2024,CSD,Pepsi,Pull-Non-Working,Agency Fees,Other,0,0,0,0,0,0,0
LAB North,Guatemala,2024,CSD,Pepsi,Pull-Non-Working,Agency Fees,Social Media / Influence Marketing,0,0,0,0,0,0,0
LAB North,Guatemala,2024,CSD,Pepsi,Pull-Non-Working,All Other Non-Working,Administrative fees,0,0,0,0,0,0,0
LAB North,Guatemala,2024,CSD,Pepsi,Pull-Non-Working,All Other Non-Working,Agency out of pocket,0,0,0,0,0,0,0
LAB North,Guatemala,2024,CSD,Pepsi,Pull-Non-Working,All Other Non-Working,CP out of pocket admin,0,0,0,0,0,0,0
LAB North,Guatemala,2024,CSD,Pepsi,Pull-Non-Working,All Other Non-Working,Grassroots/experiential out of pocket,0,0,0,0,0,0,0
LAB North,Guatemala,2024,CSD,Pepsi,Pull-Non-Working,All Other Non-Working,League/property- rights fee/options,0,0,0,0,0,0,0
LAB North,Guatemala,2024,CSD,Pepsi,Pull-Non-Working,All Other Non-Working,Market Research,0,0,0,0,0,0,0
LAB North,Guatemala,2024,CSD,Pepsi,Pull-Non-Working,All Other Non-Working,Non-allocated NW,0,0,0,0,0,0,0
LAB North,Guatemala,2024,CSD,Pepsi,Pull-Non-Working,All Other Non-Working,Other Non Working-non itemised talent,0,0,0,0,0,0,0
LAB North,Guatemala,2024,CSD,Pepsi,Pull-Non-Working,All Other Non-Working,PR out of pocket administrative,0,0,0,0,0,0,0
LAB North,Guatemala,2024,CSD,Pepsi,Pull-Non-Working,Innovation and Insight,Innovations,0,0,0,0,0,0,0
LAB North,Guatemala,2024,CSD,Pepsi,Pull-Non-Working,Innovation and Insight,Market Research,50,973224,496479,476745,124925,63729,61196
LAB North,Guatemala,2024,CSD,Pepsi,Pull-Non-Working,Package Design,Package design,0,0,0,0,0,0,0
LAB North,Guatemala,2024,CSD,Pepsi,Pull-Non-Working,Package Design,Package development,0,0,0,0,0,0,0
LAB North,Guatemala,2024,CSD,Pepsi,STB - Push,Capability Building/Other,Capability Building Other,0,0,0,0,0,0,0
LAB North,Guatemala,2024,CSD,Pepsi,STB - Push,Other Investments,CDA's,50,13299532,6797607,6501925,1707162,872558,834604
LAB North,Guatemala,2024,CSD,Pepsi,STB - Push,Other Investments,Capital (Coolers),0,0,0,0,0,0,0
LAB North,Guatemala,2024,CSD,Pepsi,STB - Push,Other Investments,Price Support,50,82331485,40473047,41858438,10568285,5195226,5373059
LAB North,Guatemala,2024,CSD,Pepsi,STB - Push,Other Investments,Vending / Racks,0,0,0,0,0,0,0
LAB North,Guatemala,2024,CSD,Pepsi,STB - Push,Other Trade,Frozen Funds,0,0,0,0,0,0,0
LAB North,Guatemala,2024,CSD,Pepsi,STB - Push,Other Trade,Other Trade,0,0,0,0,0,0,0
LAB North,Guatemala,2024,CSD,Pepsi,STB - Push,Trade Equipment,Coolers - New,50,11373206,5560976,5812230,1459894,713821,746073
LAB North,Guatemala,2024,CSD,Pepsi,STB - Push,Trade Equipment,Coolers - Refurbished,50,1400162,677796,722366,179728,87003,92725
LAB North,Guatemala,2024,CSD,Pepsi,STB - Push,Trade Equipment,Post Mix / Pre Mix Equip.,50,2893507,1527903,1365604,371418,196125,175293
LAB North,Guatemala,2024,CSD,Pepsi,STB - Push,Trade Equipment,Vending / Racks,50,1903319,973999,929320,244315,125025,119290
LAB North,Guatemala,2024,CSD,Pepsi,STB - Push,Trade Programs,Distribution Incentives,50,3469222,1798151,1671071,445318,230815,214503
LAB North,Guatemala,2024,CSD,Pepsi,STB - Push,Trade Programs,Innovation Investments,0,0,0,0,0,0,0
LAB North,Guatemala,2024,CSD,Pepsi,STB - Push,Trade Programs,Sales Incentives,50,6947156,3479583,3467573,891755,446648,445107
LAB North,Guatemala,2024,CSD,Pepsi,STB - Push,Trade Programs,Space Investments,50,13380306,6482656,6897650,1717531,832130,885401
LAB North,Guatemala,2024,CSD,Pepsi,Pull-Working,All Other Working,Other Working - PR execution,0,0,0,0,0,0,0
LAB North,Guatemala,2024,CSD,Pepsi,Pull-Working,All Other Working,Other Working - activation,0,0,0,0,0,0,0
LAB North,Guatemala,2024,CSD,Pepsi,Pull-Working,All Other Working,Other Working - non allocated working,0,0,0,0,0,0,0
LAB North,Guatemala,2024,CSD,Pepsi,Pull-Working,Consumer Promotions,Consumer Promotions Execution,50,62054580,31537492,30517088,7965488,4048235,3917253
LAB North,Guatemala,2024,CSD,Pepsi,Pull-Working,Consumer Promotions,Coupons,0,0,0,0,0,0,0
LAB North,Guatemala,2024,CSD,Pepsi,Pull-Working,Consumer Promotions,Other,0,0,0,0,0,0,0
LAB North,Guatemala,2024,CSD,Pepsi,Pull-Working,Consumer Promotions,Premiums,50,1135266,582776,552490,145725,74806,70919
LAB North,Guatemala,2024,CSD,Pepsi,Pull-Working,In Store & POS Execution,In-Store & POS Execution,50,5743545,2744714,2998831,737256,352318,384938
LAB North,Guatemala,2024,CSD,Pepsi,Pull-Working,Media Placements,Cinema,0,0,0,0,0,0,0
LAB North,Guatemala,2024,CSD,Pepsi,Pull-Working,Media Placements,Digital,50,2997630,1452353,1545277,384783,186427,198356
LAB North,Guatemala,2024,CSD,Pepsi,Pull-Working,Media Placements,OOH - Out Of Home,50,2101575,1008479,1093096,269763,129451,140312
LAB North,Guatemala,2024,CSD,Pepsi,Pull-Working,Media Placements,Other,0,0,0,0,0,0,0
LAB North,Guatemala,2024,CSD,Pepsi,Pull-Working,Media Placements,Print,50,91131,44977,46154,11697,5773,5924
LAB North,Guatemala,2024,CSD,Pepsi,Pull-Working,Media Placements,Radio,50,785899,382040,403859,100880,49039,51841
LAB North,Guatemala,2024,CSD,Pepsi,Pull-Working,Media Placements,TV,50,2140776,1019171,1121605,274795,130823,143972
LAB North,Guatemala,2024,CSD,Pepsi,Pull-Working,Sampling,Product Samples,0,0,0,0,0,0,0
LAB North,Guatemala,2024,CSD,Pepsi,Pull-Working,Sampling,Sampling Execution,50,3758179,1863058,1895121,482409,239147,243262
LAB North,Guatemala,2024,CSD,Pepsi,Pull-Working,Sponsorships,Sponsorships-in game/ in show,50,17217045,8834937,8382108,2210025,1134075,1075950
LAB North,Guatemala,2024,CSD,Pepsi,Pull-Working,Sponsorships,Sports-athlete/team contracts,50,3521282,1753330,1767952,452001,225062,226939
LAB North,Guatemala,2024,CSD,Pepsi,Pull-Working,Sponsorships,Sports-on field or in show props,0,0,0,0,0,0,0
LAB North,Guatemala,2024,CSD,Pepsi,Pull-Working,Sponsorships,Sports-stadium contracts,0,0,0,0,0,0,0
LAB North,Guatemala,2024,Others,Sabores,Pull-Non-Working,Ad Production,Digital Ad Production,0,0,0,0,0,0,0
LAB North,Guatemala,2024,Others,Sabores,Pull-Non-Working,Ad Production,"TV, Print, Radio, OOH, Production",50,203098,96904,106194,26070,12438,13632
LAB North,Guatemala,2024,Others,Sabores,Pull-Non-Working,Agency Fees,Creative Agency Fees,0,0,0,0,0,0,0
LAB North,Guatemala,2024,Others,Sabores,Pull-Non-Working,Agency Fees,In Store & POS Design / Development,0,0,0,0,0,0,0
LAB North,Guatemala,2024,Others,Sabores,Pull-Non-Working,Agency Fees,Media Agency Fees,0,0,0,0,0,0,0
LAB North,Guatemala,2024,Others,Sabores,Pull-Non-Working,Agency Fees,Other,0,0,0,0,0,0,0
LAB North,Guatemala,2024,Others,Sabores,Pull-Non-Working,Agency Fees,Social Media / Influence Marketing,0,0,0,0,0,0,0
LAB North,Guatemala,2024,Others,Sabores,Pull-Non-Working,All Other Non-Working,Administrative fees,0,0,0,0,0,0,0
LAB North,Guatemala,2024,Others,Sabores,Pull-Non-Working,All Other Non-Working,Agency out of pocket,0,0,0,0,0,0,0
LAB North,Guatemala,2024,Others,Sabores,Pull-Non-Working,All Other Non-Working,CP out of pocket admin,0,0,0,0,0,0,0
LAB North,Guatemala,2024,Others,Sabores,Pull-Non-Working,All Other Non-Working,Grassroots/experiential out of pocket,0,0,0,0,0,0,0
LAB North,Guatemala,2024,Others,Sabores,Pull-Non-Working,All Other Non-Working,League/property- rights fee/options,0,0,0,0,0,0,0
LAB North,Guatemala,2024,Others,Sabores,Pull-Non-Working,All Other Non-Working,Market Research,0,0,0,0,0,0,0
LAB North,Guatemala,2024,Others,Sabores,Pull-Non-Working,All Other Non-Working,Non-allocated NW,0,0,0,0,0,0,0
LAB North,Guatemala,2024,Others,Sabores,Pull-Non-Working,All Other Non-Working,Other Non Working-non itemised talent,0,0,0,0,0,0,0
LAB North,Guatemala,2024,Others,Sabores,Pull-Non-Working,All Other Non-Working,PR out of pocket administrative,0,0,0,0,0,0,0
LAB North,Guatemala,2024,Others,Sabores,Pull-Non-Working,Innovation and Insight,Innovations,0,0,0,0,0,0,0
LAB North,Guatemala,2024,Others,Sabores,Pull-Non-Working,Innovation and Insight,Market Research,50,65477,32179,33298,8404,4130,4274
LAB North,Guatemala,2024,Others,Sabores,Pull-Non-Working,Package Design,Package design,0,0,0,0,0,0,0
LAB North,Guatemala,2024,Others,Sabores,Pull-Non-Working,Package Design,Package development,0,0,0,0,0,0,0
LAB North,Guatemala,2024,Others,Sabores,STB - Push,Capability Building/Other,Capability Building Other,0,0,0,0,0,0,0
LAB North,Guatemala,2024,Others,Sabores,STB - Push,Other Investments,CDA's,0,0,0,0,0,0,0
LAB North,Guatemala,2024,Others,Sabores,STB - Push,Other Investments,Capital (Coolers),0,0,0,0,0,0,0
LAB North,Guatemala,2024,Others,Sabores,STB - Push,Other Investments,Price Support,0,0,0,0,0,0,0
LAB North,Guatemala,2024,Others,Sabores,STB - Push,Other Investments,Vending / Racks,0,0,0,0,0,0,0
LAB North,Guatemala,2024,Others,Sabores,STB - Push,Other Trade,Frozen Funds,0,0,0,0,0,0,0
LAB North,Guatemala,2024,Others,Sabores,STB - Push,Other Trade,Other Trade,0,0,0,0,0,0,0
LAB North,Guatemala,2024,Others,Sabores,STB - Push,Trade Equipment,Coolers - New,0,0,0,0,0,0,0
LAB North,Guatemala,2024,Others,Sabores,STB - Push,Trade Equipment,Coolers - Refurbished,0,0,0,0,0,0,0
LAB North,Guatemala,2024,Others,Sabores,STB - Push,Trade Equipment,Post Mix / Pre Mix Equip.,0,0,0,0,0,0,0
LAB North,Guatemala,2024,Others,Sabores,STB - Push,Trade Equipment,Vending / Racks,0,0,0,0,0,0,0
LAB North,Guatemala,2024,Others,Sabores,STB - Push,Trade Programs,Distribution Incentives,0,0,0,0,0,0,0
LAB North,Guatemala,2024,Others,Sabores,STB - Push,Trade Programs,Innovation Investments,0,0,0,0,0,0,0
LAB North,Guatemala,2024,Others,Sabores,STB - Push,Trade Programs,Sales Incentives,0,0,0,0,0,0,0
LAB North,Guatemala,2024,Others,Sabores,STB - Push,Trade Programs,Space Investments,0,0,0,0,0,0,0
LAB North,Guatemala,2024,Others,Sabores,Pull-Working,All Other Working,Other Working - PR execution,0,0,0,0,0,0,0
LAB North,Guatemala,2024,Others,Sabores,Pull-Working,All Other Working,Other Working - activation,0,0,0,0,0,0,0
LAB North,Guatemala,2024,Others,Sabores,Pull-Working,All Other Working,Other Working - non allocated working,0,0,0,0,0,0,0
LAB North,Guatemala,2024,Others,Sabores,Pull-Working,Consumer Promotions,Consumer Promotions Execution,50,31841,15667,16174,4087,2011,2076
LAB North,Guatemala,2024,Others,Sabores,Pull-Working,Consumer Promotions,Coupons,0,0,0,0,0,0,0
LAB North,Guatemala,2024,Others,Sabores,Pull-Working,Consumer Promotions,Other,0,0,0,0,0,0,0
LAB North,Guatemala,2024,Others,Sabores,Pull-Working,Consumer Promotions,Premiums,0,0,0,0,0,0,0
LAB North,Guatemala,2024,Others,Sabores,Pull-Working,In Store & POS Execution,In-Store & POS Execution,50,30918,15173,15745,3968,1947,2021
LAB North,Guatemala,2024,Others,Sabores,Pull-Working,Media Placements,Cinema,0,0,0,0,0,0,0
LAB North,Guatemala,2024,Others,Sabores,Pull-Working,Media Placements,Digital,50,530777,263572,267205,68131,33832,34299
LAB North,Guatemala,2024,Others,Sabores,Pull-Working,Media Placements,OOH - Out Of Home,0,0,0,0,0,0,0
LAB North,Guatemala,2024,Others,Sabores,Pull-Working,Media Placements,Other,0,0,0,0,0,0,0
LAB North,Guatemala,2024,Others,Sabores,Pull-Working,Media Placements,Print,0,0,0,0,0,0,0
LAB North,Guatemala,2024,Others,Sabores,Pull-Working,Media Placements,Radio,0,0,0,0,0,0,0
LAB North,Guatemala,2024,Others,Sabores,Pull-Working,Media Placements,TV,0,0,0,0,0,0,0
LAB North,Guatemala,2024,Others,Sabores,Pull-Working,Sampling,Product Samples,0,0,0,0,0,0,0
LAB North,Guatemala,2024,Others,Sabores,Pull-Working,Sampling,Sampling Execution,0,0,0,0,0,0,0
LAB North,Guatemala,2024,Others,Sabores,Pull-Working,Sponsorships,Sponsorships-in game/ in show,0,0,0,0,0,0,0
LAB North,Guatemala,2024,Others,Sabores,Pull-Working,Sponsorships,Sports-athlete/team contracts,0,0,0,0,0,0,0
LAB North,Guatemala,2024,Others,Sabores,Pull-Working,Sponsorships,Sports-on field or in show props,0,0,0,0,0,0,0
LAB North,Guatemala,2024,Others,Sabores,Pull-Working,Sponsorships,Sports-stadium contracts,0,0,0,0,0,0,0
LAB North,HN-CBC,2024,Energy Drinks,AMP,Pull-Non-Working,Ad Production,Digital Ad Production,0,0,0,0,0,0,0
LAB North,HN-CBC,2024,Energy Drinks,AMP,Pull-Non-Working,Ad Production,"TV, Print, Radio, OOH, Production",50,427638,222976,204662,17367,9055,8312
LAB North,HN-CBC,2024,Energy Drinks,AMP,Pull-Non-Working,Agency Fees,Creative Agency Fees,0,0,0,0,0,0,0
LAB North,HN-CBC,2024,Energy Drinks,AMP,Pull-Non-Working,Agency Fees,In Store & POS Design / Development,0,0,0,0,0,0,0
LAB North,HN-CBC,2024,Energy Drinks,AMP,Pull-Non-Working,Agency Fees,Media Agency Fees,0,0,0,0,0,0,0
LAB North,HN-CBC,2024,Energy Drinks,AMP,Pull-Non-Working,Agency Fees,Other,0,0,0,0,0,0,0
LAB North,HN-CBC,2024,Energy Drinks,AMP,Pull-Non-Working,Agency Fees,Social Media / Influence Marketing,0,0,0,0,0,0,0
LAB North,HN-CBC,2024,Energy Drinks,AMP,Pull-Non-Working,All Other Non-Working,Administrative fees,0,0,0,0,0,0,0
LAB North,HN-CBC,2024,Energy Drinks,AMP,Pull-Non-Working,All Other Non-Working,Agency out of pocket,0,0,0,0,0,0,0
LAB North,HN-CBC,2024,Energy Drinks,AMP,Pull-Non-Working,All Other Non-Working,CP out of pocket admin,0,0,0,0,0,0,0
LAB North,HN-CBC,2024,Energy Drinks,AMP,Pull-Non-Working,All Other Non-Working,Grassroots/experiential out of pocket,0,0,0,0,0,0,0
LAB North,HN-CBC,2024,Energy Drinks,AMP,Pull-Non-Working,All Other Non-Working,League/property- rights fee/options,0,0,0,0,0,0,0
LAB North,HN-CBC,2024,Energy Drinks,AMP,Pull-Non-Working,All Other Non-Working,Market Research,0,0,0,0,0,0,0
LAB North,HN-CBC,2024,Energy Drinks,AMP,Pull-Non-Working,All Other Non-Working,Non-allocated NW,0,0,0,0,0,0,0
LAB North,HN-CBC,2024,Energy Drinks,AMP,Pull-Non-Working,All Other Non-Working,Other Non Working-non itemised talent,0,0,0,0,0,0,0
LAB North,HN-CBC,2024,Energy Drinks,AMP,Pull-Non-Working,All Other Non-Working,PR out of pocket administrative,0,0,0,0,0,0,0
LAB North,HN-CBC,2024,Energy Drinks,AMP,Pull-Non-Working,Innovation and Insight,Innovations,0,0,0,0,0,0,0
LAB North,HN-CBC,2024,Energy Drinks,AMP,Pull-Non-Working,Innovation and Insight,Market Research,0,0,0,0,0,0,0
LAB North,HN-CBC,2024,Energy Drinks,AMP,Pull-Non-Working,Package Design,Package design,0,0,0,0,0,0,0
LAB North,HN-CBC,2024,Energy Drinks,AMP,Pull-Non-Working,Package Design,Package development,0,0,0,0,0,0,0
LAB North,HN-CBC,2024,Energy Drinks,AMP,STB - Push,Capability Building/Other,Capability Building Other,0,0,0,0,0,0,0
LAB North,HN-CBC,2024,Energy Drinks,AMP,STB - Push,Other Investments,CDA's,0,0,0,0,0,0,0
LAB North,HN-CBC,2024,Energy Drinks,AMP,STB - Push,Other Investments,Capital (Coolers),0,0,0,0,0,0,0
LAB North,HN-CBC,2024,Energy Drinks,AMP,STB - Push,Other Investments,Price Support,50,12561721,6051245,6510476,510176,245762,264414
LAB North,HN-CBC,2024,Energy Drinks,AMP,STB - Push,Other Investments,Vending / Racks,0,0,0,0,0,0,0
LAB North,HN-CBC,2024,Energy Drinks,AMP,STB - Push,Other Trade,Frozen Funds,0,0,0,0,0,0,0
LAB North,HN-CBC,2024,Energy Drinks,AMP,STB - Push,Other Trade,Other Trade,0,0,0,0,0,0,0
LAB North,HN-CBC,2024,Energy Drinks,AMP,STB - Push,Trade Equipment,Coolers - New,0,0,0,0,0,0,0
LAB North,HN-CBC,2024,Energy Drinks,AMP,STB - Push,Trade Equipment,Coolers - Refurbished,0,0,0,0,0,0,0
LAB North,HN-CBC,2024,Energy Drinks,AMP,STB - Push,Trade Equipment,Post Mix / Pre Mix Equip.,0,0,0,0,0,0,0
LAB North,HN-CBC,2024,Energy Drinks,AMP,STB - Push,Trade Equipment,Vending / Racks,0,0,0,0,0,0,0
LAB North,HN-CBC,2024,Energy Drinks,AMP,STB - Push,Trade Programs,Distribution Incentives,0,0,0,0,0,0,0
LAB North,HN-CBC,2024,Energy Drinks,AMP,STB - Push,Trade Programs,Innovation Investments,0,0,0,0,0,0,0
LAB North,HN-CBC,2024,Energy Drinks,AMP,STB - Push,Trade Programs,Sales Incentives,0,0,0,0,0,0,0
LAB North,HN-CBC,2024,Energy Drinks,AMP,STB - Push,Trade Programs,Space Investments,0,0,0,0,0,0,0
LAB North,HN-CBC,2024,Energy Drinks,AMP,Pull-Working,All Other Working,Other Working - PR execution,50,193311,96813,96498,7851,3931,3920
LAB North,HN-CBC,2024,Energy Drinks,AMP,Pull-Working,All Other Working,Other Working - activation,0,0,0,0,0,0,0
LAB North,HN-CBC,2024,Energy Drinks,AMP,Pull-Working,All Other Working,Other Working - non allocated working,0,0,0,0,0,0,0
LAB North,HN-CBC,2024,Energy Drinks,AMP,Pull-Working,Consumer Promotions,Consumer Promotions Execution,50,1049211,523109,526102,42612,21245,21367
LAB North,HN-CBC,2024,Energy Drinks,AMP,Pull-Working,Consumer Promotions,Coupons,0,0,0,0,0,0,0
LAB North,HN-CBC,2024,Energy Drinks,AMP,Pull-Working,Consumer Promotions,Other,0,0,0,0,0,0,0
LAB North,HN-CBC,2024,Energy Drinks,AMP,Pull-Working,Consumer Promotions,Premiums,0,0,0,0,0,0,0
LAB North,HN-CBC,2024,Energy Drinks,AMP,Pull-Working,In Store & POS Execution,In-Store & POS Execution,0,0,0,0,0,0,0
LAB North,HN-CBC,2024,Energy Drinks,AMP,Pull-Working,Media Placements,Cinema,0,0,0,0,0,0,0
LAB North,HN-CBC,2024,Energy Drinks,AMP,Pull-Working,Media Placements,Digital,50,3052520,1526967,1525553,123973,62015,61958
LAB North,HN-CBC,2024,Energy Drinks,AMP,Pull-Working,Media Placements,OOH - Out Of Home,50,1691662,899589,792073,68704,36535,32169
LAB North,HN-CBC,2024,Energy Drinks,AMP,Pull-Working,Media Placements,Other,50,400545,201386,199159,16267,8179,8088
LAB North,HN-CBC,2024,Energy Drinks,AMP,Pull-Working,Media Placements,Print,0,0,0,0,0,0,0
LAB North,HN-CBC,2024,Energy Drinks,AMP,Pull-Working,Media Placements,Radio,50,325993,167677,158316,13239,6809,6430
LAB North,HN-CBC,2024,Energy Drinks,AMP,Pull-Working,Media Placements,TV,50,1361289,691636,669653,55286,28089,27197
LAB North,HN-CBC,2024,Energy Drinks,AMP,Pull-Working,Sampling,Product Samples,0,0,0,0,0,0,0
LAB North,HN-CBC,2024,Energy Drinks,AMP,Pull-Working,Sampling,Sampling Execution,50,631982,309703,322279,25667,12578,13089
LAB North,HN-CBC,2024,Energy Drinks,AMP,Pull-Working,Sponsorships,Sponsorships-in game/ in show,0,0,0,0,0,0,0
LAB North,HN-CBC,2024,Energy Drinks,AMP,Pull-Working,Sponsorships,Sports-athlete/team contracts,0,0,0,0,0,0,0
LAB North,HN-CBC,2024,Energy Drinks,AMP,Pull-Working,Sponsorships,Sports-on field or in show props,0,0,0,0,0,0,0
LAB North,HN-CBC,2024,Energy Drinks,AMP,Pull-Working,Sponsorships,Sports-stadium contracts,0,0,0,0,0,0,0
LAB North,HN-CBC,2024,Energy Drinks,Adrenaline,Pull-Non-Working,Ad Production,Digital Ad Production,0,0,0,0,0,0,0
LAB North,HN-CBC,2024,Energy Drinks,Adrenaline,Pull-Non-Working,Ad Production,"TV, Print, Radio, OOH, Production",50,1124373,571637,552736,45664,23216,22448
LAB North,HN-CBC,2024,Energy Drinks,Adrenaline,Pull-Non-Working,Agency Fees,Creative Agency Fees,0,0,0,0,0,0,0
LAB North,HN-CBC,2024,Energy Drinks,Adrenaline,Pull-Non-Working,Agency Fees,In Store & POS Design / Development,0,0,0,0,0,0,0
LAB North,HN-CBC,2024,Energy Drinks,Adrenaline,Pull-Non-Working,Agency Fees,Media Agency Fees,0,0,0,0,0,0,0
LAB North,HN-CBC,2024,Energy Drinks,Adrenaline,Pull-Non-Working,Agency Fees,Other,0,0,0,0,0,0,0
LAB North,HN-CBC,2024,Energy Drinks,Adrenaline,Pull-Non-Working,Agency Fees,Social Media / Influence Marketing,0,0,0,0,0,0,0
LAB North,HN-CBC,2024,Energy Drinks,Adrenaline,Pull-Non-Working,All Other Non-Working,Administrative fees,0,0,0,0,0,0,0
LAB North,HN-CBC,2024,Energy Drinks,Adrenaline,Pull-Non-Working,All Other Non-Working,Agency out of pocket,0,0,0,0,0,0,0
LAB North,HN-CBC,2024,Energy Drinks,Adrenaline,Pull-Non-Working,All Other Non-Working,CP out of pocket admin,0,0,0,0,0,0,0
LAB North,HN-CBC,2024,Energy Drinks,Adrenaline,Pull-Non-Working,All Other Non-Working,Grassroots/experiential out of pocket,0,0,0,0,0,0,0
LAB North,HN-CBC,2024,Energy Drinks,Adrenaline,Pull-Non-Working,All Other Non-Working,League/property- rights fee/options,0,0,0,0,0,0,0
LAB North,HN-CBC,2024,Energy Drinks,Adrenaline,Pull-Non-Working,All Other Non-Working,Market Research,0,0,0,0,0,0,0
LAB North,HN-CBC,2024,Energy Drinks,Adrenaline,Pull-Non-Working,All Other Non-Working,Non-allocated NW,0,0,0,0,0,0,0
LAB North,HN-CBC,2024,Energy Drinks,Adrenaline,Pull-Non-Working,All Other Non-Working,Other Non Working-non itemised talent,0,0,0,0,0,0,0
LAB North,HN-CBC,2024,Energy Drinks,Adrenaline,Pull-Non-Working,All Other Non-Working,PR out of pocket administrative,0,0,0,0,0,0,0
LAB North,HN-CBC,2024,Energy Drinks,Adrenaline,Pull-Non-Working,Innovation and Insight,Innovations,0,0,0,0,0,0,0
LAB North,HN-CBC,2024,Energy Drinks,Adrenaline,Pull-Non-Working,Innovation and Insight,Market Research,0,0,0,0,0,0,0
LAB North,HN-CBC,2024,Energy Drinks,Adrenaline,Pull-Non-Working,Package Design,Package design,0,0,0,0,0,0,0
LAB North,HN-CBC,2024,Energy Drinks,Adrenaline,Pull-Non-Working,Package Design,Package development,0,0,0,0,0,0,0
LAB North,HN-CBC,2024,Energy Drinks,Adrenaline,STB - Push,Capability Building/Other,Capability Building Other,0,0,0,0,0,0,0
LAB North,HN-CBC,2024,Energy Drinks,Adrenaline,STB - Push,Other Investments,CDA's,0,0,0,0,0,0,0
LAB North,HN-CBC,2024,Energy Drinks,Adrenaline,STB - Push,Other Investments,Capital (Coolers),0,0,0,0,0,0,0
LAB North,HN-CBC,2024,Energy Drinks,Adrenaline,STB - Push,Other Investments,Price Support,50,7949985,3759681,4190304,322877,152694,170183
LAB North,HN-CBC,2024,Energy Drinks,Adrenaline,STB - Push,Other Investments,Vending / Racks,0,0,0,0,0,0,0
LAB North,HN-CBC,2024,Energy Drinks,Adrenaline,STB - Push,Other Trade,Frozen Funds,0,0,0,0,0,0,0
LAB North,HN-CBC,2024,Energy Drinks,Adrenaline,STB - Push,Other Trade,Other Trade,0,0,0,0,0,0,0
LAB North,HN-CBC,2024,Energy Drinks,Adrenaline,STB - Push,Trade Equipment,Coolers - New,0,0,0,0,0,0,0
LAB North,HN-CBC,2024,Energy Drinks,Adrenaline,STB - Push,Trade Equipment,Coolers - Refurbished,0,0,0,0,0,0,0
LAB North,HN-CBC,2024,Energy Drinks,Adrenaline,STB - Push,Trade Equipment,Post Mix / Pre Mix Equip.,0,0,0,0,0,0,0
LAB North,HN-CBC,2024,Energy Drinks,Adrenaline,STB - Push,Trade Equipment,Vending / Racks,0,0,0,0,0,0,0
LAB North,HN-CBC,2024,Energy Drinks,Adrenaline,STB - Push,Trade Programs,Distribution Incentives,0,0,0,0,0,0,0
LAB North,HN-CBC,2024,Energy Drinks,Adrenaline,STB - Push,Trade Programs,Innovation Investments,0,0,0,0,0,0,0
LAB North,HN-CBC,2024,Energy Drinks,Adrenaline,STB - Push,Trade Programs,Sales Incentives,0,0,0,0,0,0,0
LAB North,HN-CBC,2024,Energy Drinks,Adrenaline,STB - Push,Trade Programs,Space Investments,0,0,0,0,0,0,0
LAB North,HN-CBC,2024,Energy Drinks,Adrenaline,Pull-Working,All Other Working,Other Working - PR execution,0,0,0,0,0,0,0
LAB North,HN-CBC,2024,Energy Drinks,Adrenaline,Pull-Working,All Other Working,Other Working - activation,0,0,0,0,0,0,0
LAB North,HN-CBC,2024,Energy Drinks,Adrenaline,Pull-Working,All Other Working,Other Working - non allocated working,0,0,0,0,0,0,0
LAB North,HN-CBC,2024,Energy Drinks,Adrenaline,Pull-Working,Consumer Promotions,Consumer Promotions Execution,0,0,0,0,0,0,0
LAB North,HN-CBC,2024,Energy Drinks,Adrenaline,Pull-Working,Consumer Promotions,Coupons,0,0,0,0,0,0,0
LAB North,HN-CBC,2024,Energy Drinks,Adrenaline,Pull-Working,Consumer Promotions,Other,0,0,0,0,0,0,0
LAB North,HN-CBC,2024,Energy Drinks,Adrenaline,Pull-Working,Consumer Promotions,Premiums,50,280479,138131,142348,11391,5609,5782
LAB North,HN-CBC,2024,Energy Drinks,Adrenaline,Pull-Working,In Store & POS Execution,In-Store & POS Execution,0,0,0,0,0,0,0
LAB North,HN-CBC,2024,Energy Drinks,Adrenaline,Pull-Working,Media Placements,Cinema,0,0,0,0,0,0,0
LAB North,HN-CBC,2024,Energy Drinks,Adrenaline,Pull-Working,Media Placements,Digital,50,783432,404406,379026,31818,16424,15394
LAB North,HN-CBC,2024,Energy Drinks,Adrenaline,Pull-Working,Media Placements,OOH - Out Of Home,0,0,0,0,0,0,0
LAB North,HN-CBC,2024,Energy Drinks,Adrenaline,Pull-Working,Media Placements,Other,0,0,0,0,0,0,0
LAB North,HN-CBC,2024,Energy Drinks,Adrenaline,Pull-Working,Media Placements,Print,0,0,0,0,0,0,0
LAB North,HN-CBC,2024,Energy Drinks,Adrenaline,Pull-Working,Media Placements,Radio,0,0,0,0,0,0,0
LAB North,HN-CBC,2024,Energy Drinks,Adrenaline,Pull-Working,Media Placements,TV,0,0,0,0,0,0,0
LAB North,HN-CBC,2024,Energy Drinks,Adrenaline,Pull-Working,Sampling,Product Samples,50,17322,8811,8511,703,357,346
LAB North,HN-CBC,2024,Energy Drinks,Adrenaline,Pull-Working,Sampling,Sampling Execution,0,0,0,0,0,0,0
LAB North,HN-CBC,2024,Energy Drinks,Adrenaline,Pull-Working,Sponsorships,Sponsorships-in game/ in show,50,13308,6927,6381,540,281,259
LAB North,HN-CBC,2024,Energy Drinks,Adrenaline,Pull-Working,Sponsorships,Sports-athlete/team contracts,0,0,0,0,0,0,0
LAB North,HN-CBC,2024,Energy Drinks,Adrenaline,Pull-Working,Sponsorships,Sports-on field or in show props,0,0,0,0,0,0,0
LAB North,HN-CBC,2024,Energy Drinks,Adrenaline,Pull-Working,Sponsorships,Sports-stadium contracts,0,0,0,0,0,0,0
LAB North,HN-CBC,2024,Sport Drinks,Gatorade,Pull-Non-Working,Ad Production,Digital Ad Production,0,0,0,0,0,0,0
LAB North,HN-CBC,2024,Sport Drinks,Gatorade,Pull-Non-Working,Ad Production,"TV, Print, Radio, OOH, Production",50,1432065,719242,712823,58161,29211,28950
LAB North,HN-CBC,2024,Sport Drinks,Gatorade,Pull-Non-Working,Agency Fees,Creative Agency Fees,0,0,0,0,0,0,0
LAB North,HN-CBC,2024,Sport Drinks,Gatorade,Pull-Non-Working,Agency Fees,In Store & POS Design / Development,0,0,0,0,0,0,0
LAB North,HN-CBC,2024,Sport Drinks,Gatorade,Pull-Non-Working,Agency Fees,Media Agency Fees,0,0,0,0,0,0,0
LAB North,HN-CBC,2024,Sport Drinks,Gatorade,Pull-Non-Working,Agency Fees,Other,0,0,0,0,0,0,0
LAB North,HN-CBC,2024,Sport Drinks,Gatorade,Pull-Non-Working,Agency Fees,Social Media / Influence Marketing,0,0,0,0,0,0,0
LAB North,HN-CBC,2024,Sport Drinks,Gatorade,Pull-Non-Working,All Other Non-Working,Administrative fees,0,0,0,0,0,0,0
LAB North,HN-CBC,2024,Sport Drinks,Gatorade,Pull-Non-Working,All Other Non-Working,Agency out of pocket,0,0,0,0,0,0,0
LAB North,HN-CBC,2024,Sport Drinks,Gatorade,Pull-Non-Working,All Other Non-Working,CP out of pocket admin,0,0,0,0,0,0,0
LAB North,HN-CBC,2024,Sport Drinks,Gatorade,Pull-Non-Working,All Other Non-Working,Grassroots/experiential out of pocket,0,0,0,0,0,0,0
LAB North,HN-CBC,2024,Sport Drinks,Gatorade,Pull-Non-Working,All Other Non-Working,League/property- rights fee/options,0,0,0,0,0,0,0
LAB North,HN-CBC,2024,Sport Drinks,Gatorade,Pull-Non-Working,All Other Non-Working,Market Research,0,0,0,0,0,0,0
LAB North,HN-CBC,2024,Sport Drinks,Gatorade,Pull-Non-Working,All Other Non-Working,Non-allocated NW,0,0,0,0,0,0,0
LAB North,HN-CBC,2024,Sport Drinks,Gatorade,Pull-Non-Working,All Other Non-Working,Other Non Working-non itemised talent,0,0,0,0,0,0,0
LAB North,HN-CBC,2024,Sport Drinks,Gatorade,Pull-Non-Working,All Other Non-Working,PR out of pocket administrative,0,0,0,0,0,0,0
LAB North,HN-CBC,2024,Sport Drinks,Gatorade,Pull-Non-Working,Innovation and Insight,Innovations,0,0,0,0,0,0,0
LAB North,HN-CBC,2024,Sport Drinks,Gatorade,Pull-Non-Working,Innovation and Insight,Market Research,0,0,0,0,0,0,0
LAB North,HN-CBC,2024,Sport Drinks,Gatorade,Pull-Non-Working,Package Design,Package design,0,0,0,0,0,0,0
LAB North,HN-CBC,2024,Sport Drinks,Gatorade,Pull-Non-Working,Package Design,Package development,0,0,0,0,0,0,0
LAB North,HN-CBC,2024,Sport Drinks,Gatorade,STB - Push,Capability Building/Other,Capability Building Other,0,0,0,0,0,0,0
LAB North,HN-CBC,2024,Sport Drinks,Gatorade,STB - Push,Other Investments,CDA's,0,0,0,0,0,0,0
LAB North,HN-CBC,2024,Sport Drinks,Gatorade,STB - Push,Other Investments,Capital (Coolers),0,0,0,0,0,0,0
LAB North,HN-CBC,2024,Sport Drinks,Gatorade,STB - Push,Other Investments,Price Support,50,13898913,7150960,6747953,564485,290426,274059
LAB North,HN-CBC,2024,Sport Drinks,Gatorade,STB - Push,Other Investments,Vending / Racks,0,0,0,0,0,0,0
LAB North,HN-CBC,2024,Sport Drinks,Gatorade,STB - Push,Other Trade,Frozen Funds,0,0,0,0,0,0,0
LAB North,HN-CBC,2024,Sport Drinks,Gatorade,STB - Push,Other Trade,Other Trade,0,0,0,0,0,0,0
LAB North,HN-CBC,2024,Sport Drinks,Gatorade,STB - Push,Trade Equipment,Coolers - New,0,0,0,0,0,0,0
LAB North,HN-CBC,2024,Sport Drinks,Gatorade,STB - Push,Trade Equipment,Coolers - Refurbished,0,0,0,0,0,0,0
LAB North,HN-CBC,2024,Sport Drinks,Gatorade,STB - Push,Trade Equipment,Post Mix / Pre Mix Equip.,0,0,0,0,0,0,0
LAB North,HN-CBC,2024,Sport Drinks,Gatorade,STB - Push,Trade Equipment,Vending / Racks,0,0,0,0,0,0,0
LAB North,HN-CBC,2024,Sport Drinks,Gatorade,STB - Push,Trade Programs,Distribution Incentives,0,0,0,0,0,0,0
LAB North,HN-CBC,2024,Sport Drinks,Gatorade,STB - Push,Trade Programs,Innovation Investments,0,0,0,0,0,0,0
LAB North,HN-CBC,2024,Sport Drinks,Gatorade,STB - Push,Trade Programs,Sales Incentives,0,0,0,0,0,0,0
LAB North,HN-CBC,2024,Sport Drinks,Gatorade,STB - Push,Trade Programs,Space Investments,0,0,0,0,0,0,0
LAB North,HN-CBC,2024,Sport Drinks,Gatorade,Pull-Working,All Other Working,Other Working - PR execution,0,0,0,0,0,0,0
LAB North,HN-CBC,2024,Sport Drinks,Gatorade,Pull-Working,All Other Working,Other Working - activation,0,0,0,0,0,0,0
LAB North,HN-CBC,2024,Sport Drinks,Gatorade,Pull-Working,All Other Working,Other Working - non allocated working,0,0,0,0,0,0,0
LAB North,HN-CBC,2024,Sport Drinks,Gatorade,Pull-Working,Consumer Promotions,Consumer Promotions Execution,50,66976,34027,32949,2720,1381,1339
LAB North,HN-CBC,2024,Sport Drinks,Gatorade,Pull-Working,Consumer Promotions,Coupons,0,0,0,0,0,0,0
LAB North,HN-CBC,2024,Sport Drinks,Gatorade,Pull-Working,Consumer Promotions,Other,0,0,0,0,0,0,0
LAB North,HN-CBC,2024,Sport Drinks,Gatorade,Pull-Working,Consumer Promotions,Premiums,50,1165205,593606,571599,47323,24108,23215
LAB North,HN-CBC,2024,Sport Drinks,Gatorade,Pull-Working,In Store & POS Execution,In-Store & POS Execution,0,0,0,0,0,0,0
LAB North,HN-CBC,2024,Sport Drinks,Gatorade,Pull-Working,Media Placements,Cinema,0,0,0,0,0,0,0
LAB North,HN-CBC,2024,Sport Drinks,Gatorade,Pull-Working,Media Placements,Digital,50,2138090,1065146,1072944,86835,43259,43576
LAB North,HN-CBC,2024,Sport Drinks,Gatorade,Pull-Working,Media Placements,OOH - Out Of Home,50,1468299,711205,757094,59632,28884,30748
LAB North,HN-CBC,2024,Sport Drinks,Gatorade,Pull-Working,Media Placements,Other,0,0,0,0,0,0,0
LAB North,HN-CBC,2024,Sport Drinks,Gatorade,Pull-Working,Media Placements,Print,0,0,0,0,0,0,0
LAB North,HN-CBC,2024,Sport Drinks,Gatorade,Pull-Working,Media Placements,Radio,50,98740,46412,52328,4010,1884,2126
LAB North,HN-CBC,2024,Sport Drinks,Gatorade,Pull-Working,Media Placements,TV,50,372079,186718,185361,15111,7583,7528
LAB North,HN-CBC,2024,Sport Drinks,Gatorade,Pull-Working,Sampling,Product Samples,50,39340,18974,20366,1597,770,827
LAB North,HN-CBC,2024,Sport Drinks,Gatorade,Pull-Working,Sampling,Sampling Execution,50,69770,34353,35417,2833,1395,1438
LAB North,HN-CBC,2024,Sport Drinks,Gatorade,Pull-Working,Sponsorships,Sponsorships-in game/ in show,50,179503,90181,89322,7290,3662,3628
LAB North,HN-CBC,2024,Sport Drinks,Gatorade,Pull-Working,Sponsorships,Sports-athlete/team contracts,0,0,0,0,0,0,0
LAB North,HN-CBC,2024,Sport Drinks,Gatorade,Pull-Working,Sponsorships,Sports-on field or in show props,0,0,0,0,0,0,0
LAB North,HN-CBC,2024,Sport Drinks,Gatorade,Pull-Working,Sponsorships,Sports-stadium contracts,0,0,0,0,0,0,0
LAB North,HN-CBC,2024,RTD Tea,Lipton,Pull-Non-Working,Ad Production,Digital Ad Production,0,0,0,0,0,0,0
LAB North,HN-CBC,2024,RTD Tea,Lipton,Pull-Non-Working,Ad Production,"TV, Print, Radio, OOH, Production",50,926853,478844,448009,37642,19447,18195
LAB North,HN-CBC,2024,RTD Tea,Lipton,Pull-Non-Working,Agency Fees,Creative Agency Fees,0,0,0,0,0,0,0
LAB North,HN-CBC,2024,RTD Tea,Lipton,Pull-Non-Working,Agency Fees,In Store & POS Design / Development,0,0,0,0,0,0,0
LAB North,HN-CBC,2024,RTD Tea,Lipton,Pull-Non-Working,Agency Fees,Media Agency Fees,0,0,0,0,0,0,0
LAB North,HN-CBC,2024,RTD Tea,Lipton,Pull-Non-Working,Agency Fees,Other,0,0,0,0,0,0,0
LAB North,HN-CBC,2024,RTD Tea,Lipton,Pull-Non-Working,Agency Fees,Social Media / Influence Marketing,0,0,0,0,0,0,0
LAB North,HN-CBC,2024,RTD Tea,Lipton,Pull-Non-Working,All Other Non-Working,Administrative fees,0,0,0,0,0,0,0
LAB North,HN-CBC,2024,RTD Tea,Lipton,Pull-Non-Working,All Other Non-Working,Agency out of pocket,0,0,0,0,0,0,0
LAB North,HN-CBC,2024,RTD Tea,Lipton,Pull-Non-Working,All Other Non-Working,CP out of pocket admin,0,0,0,0,0,0,0
LAB North,HN-CBC,2024,RTD Tea,Lipton,Pull-Non-Working,All Other Non-Working,Grassroots/experiential out of pocket,0,0,0,0,0,0,0
LAB North,HN-CBC,2024,RTD Tea,Lipton,Pull-Non-Working,All Other Non-Working,League/property- rights fee/options,0,0,0,0,0,0,0
LAB North,HN-CBC,2024,RTD Tea,Lipton,Pull-Non-Working,All Other Non-Working,Market Research,0,0,0,0,0,0,0
LAB North,HN-CBC,2024,RTD Tea,Lipton,Pull-Non-Working,All Other Non-Working,Non-allocated NW,0,0,0,0,0,0,0
LAB North,HN-CBC,2024,RTD Tea,Lipton,Pull-Non-Working,All Other Non-Working,Other Non Working-non itemised talent,0,0,0,0,0,0,0
LAB North,HN-CBC,2024,RTD Tea,Lipton,Pull-Non-Working,All Other Non-Working,PR out of pocket administrative,0,0,0,0,0,0,0
LAB North,HN-CBC,2024,RTD Tea,Lipton,Pull-Non-Working,Innovation and Insight,Innovations,0,0,0,0,0,0,0
LAB North,HN-CBC,2024,RTD Tea,Lipton,Pull-Non-Working,Innovation and Insight,Market Research,0,0,0,0,0,0,0
LAB North,HN-CBC,2024,RTD Tea,Lipton,Pull-Non-Working,Package Design,Package design,0,0,0,0,0,0,0
LAB North,HN-CBC,2024,RTD Tea,Lipton,Pull-Non-Working,Package Design,Package development,0,0,0,0,0,0,0
LAB North,HN-CBC,2024,RTD Tea,Lipton,STB - Push,Capability Building/Other,Capability Building Other,0,0,0,0,0,0,0
LAB North,HN-CBC,2024,RTD Tea,Lipton,STB - Push,Other Investments,CDA's,0,0,0,0,0,0,0
LAB North,HN-CBC,2024,RTD Tea,Lipton,STB - Push,Other Investments,Capital (Coolers),0,0,0,0,0,0,0
LAB North,HN-CBC,2024,RTD Tea,Lipton,STB - Push,Other Investments,Price Support,50,14218799,7148394,7070405,577476,290322,287154
LAB North,HN-CBC,2024,RTD Tea,Lipton,STB - Push,Other Investments,Vending / Racks,0,0,0,0,0,0,0
LAB North,HN-CBC,2024,RTD Tea,Lipton,STB - Push,Other Trade,Frozen Funds,0,0,0,0,0,0,0
LAB North,HN-CBC,2024,RTD Tea,Lipton,STB - Push,Other Trade,Other Trade,0,0,0,0,0,0,0
LAB North,HN-CBC,2024,RTD Tea,Lipton,STB - Push,Trade Equipment,Coolers - New,0,0,0,0,0,0,0
LAB North,HN-CBC,2024,RTD Tea,Lipton,STB - Push,Trade Equipment,Coolers - Refurbished,0,0,0,0,0,0,0
LAB North,HN-CBC,2024,RTD Tea,Lipton,STB - Push,Trade Equipment,Post Mix / Pre Mix Equip.,0,0,0,0,0,0,0
LAB North,HN-CBC,2024,RTD Tea,Lipton,STB - Push,Trade Equipment,Vending / Racks,0,0,0,0,0,0,0
LAB North,HN-CBC,2024,RTD Tea,Lipton,STB - Push,Trade Programs,Distribution Incentives,0,0,0,0,0,0,0
LAB North,HN-CBC,2024,RTD Tea,Lipton,STB - Push,Trade Programs,Innovation Investments,0,0,0,0,0,0,0
LAB North,HN-CBC,2024,RTD Tea,Lipton,STB - Push,Trade Programs,Sales Incentives,0,0,0,0,0,0,0
LAB North,HN-CBC,2024,RTD Tea,Lipton,STB - Push,Trade Programs,Space Investments,0,0,0,0,0,0,0
LAB North,HN-CBC,2024,RTD Tea,Lipton,Pull-Working,All Other Working,Other Working - PR execution,50,84130,42293,41837,3416,1717,1699
LAB North,HN-CBC,2024,RTD Tea,Lipton,Pull-Working,All Other Working,Other Working - activation,0,0,0,0,0,0,0
LAB North,HN-CBC,2024,RTD Tea,Lipton,Pull-Working,All Other Working,Other Working - non allocated working,0,0,0,0,0,0,0
LAB North,HN-CBC,2024,RTD Tea,Lipton,Pull-Working,Consumer Promotions,Consumer Promotions Execution,0,0,0,0,0,0,0
LAB North,HN-CBC,2024,RTD Tea,Lipton,Pull-Working,Consumer Promotions,Coupons,0,0,0,0,0,0,0
LAB North,HN-CBC,2024,RTD Tea,Lipton,Pull-Working,Consumer Promotions,Other,0,0,0,0,0,0,0
LAB North,HN-CBC,2024,RTD Tea,Lipton,Pull-Working,Consumer Promotions,Premiums,50,411033,203774,207259,16693,8275,8418
LAB North,HN-CBC,2024,RTD Tea,Lipton,Pull-Working,In Store & POS Execution,In-Store & POS Execution,0,0,0,0,0,0,0
LAB North,HN-CBC,2024,RTD Tea,Lipton,Pull-Working,Media Placements,Cinema,0,0,0,0,0,0,0
LAB North,HN-CBC,2024,RTD Tea,Lipton,Pull-Working,Media Placements,Digital,50,1375581,692280,683301,55867,28115,27752
LAB North,HN-CBC,2024,RTD Tea,Lipton,Pull-Working,Media Placements,OOH - Out Of Home,0,0,0,0,0,0,0
LAB North,HN-CBC,2024,RTD Tea,Lipton,Pull-Working,Media Placements,Other,0,0,0,0,0,0,0
LAB North,HN-CBC,2024,RTD Tea,Lipton,Pull-Working,Media Placements,Print,0,0,0,0,0,0,0
LAB North,HN-CBC,2024,RTD Tea,Lipton,Pull-Working,Media Placements,Radio,0,0,0,0,0,0,0
LAB North,HN-CBC,2024,RTD Tea,Lipton,Pull-Working,Media Placements,TV,0,0,0,0,0,0,0
LAB North,HN-CBC,2024,RTD Tea,Lipton,Pull-Working,Sampling,Product Samples,50,16279,8075,8204,661,327,334
LAB North,HN-CBC,2024,RTD Tea,Lipton,Pull-Working,Sampling,Sampling Execution,0,0,0,0,0,0,0
LAB North,HN-CBC,2024,RTD Tea,Lipton,Pull-Working,Sponsorships,Sponsorships-in game/ in show,50,60162,29326,30836,2443,1191,1252
LAB North,HN-CBC,2024,RTD Tea,Lipton,Pull-Working,Sponsorships,Sports-athlete/team contracts,0,0,0,0,0,0,0
LAB North,HN-CBC,2024,RTD Tea,Lipton,Pull-Working,Sponsorships,Sports-on field or in show props,0,0,0,0,0,0,0
LAB North,HN-CBC,2024,RTD Tea,Lipton,Pull-Working,Sponsorships,Sports-stadium contracts,0,0,0,0,0,0,0
LAB North,HN-CBC,2024,CSD,Pepsi,Pull-Non-Working,Ad Production,Digital Ad Production,0,0,0,0,0,0,0
LAB North,HN-CBC,2024,CSD,Pepsi,Pull-Non-Working,Ad Production,"TV, Print, Radio, OOH, Production",50,6097200,2921957,3175243,247629,118671,128958
LAB North,HN-CBC,2024,CSD,Pepsi,Pull-Non-Working,Agency Fees,Creative Agency Fees,0,0,0,0,0,0,0
LAB North,HN-CBC,2024,CSD,Pepsi,Pull-Non-Working,Agency Fees,In Store & POS Design / Development,0,0,0,0,0,0,0
LAB North,HN-CBC,2024,CSD,Pepsi,Pull-Non-Working,Agency Fees,Media Agency Fees,0,0,0,0,0,0,0
LAB North,HN-CBC,2024,CSD,Pepsi,Pull-Non-Working,Agency Fees,Other,0,0,0,0,0,0,0
LAB North,HN-CBC,2024,CSD,Pepsi,Pull-Non-Working,Agency Fees,Social Media / Influence Marketing,0,0,0,0,0,0,0
LAB North,HN-CBC,2024,CSD,Pepsi,Pull-Non-Working,All Other Non-Working,Administrative fees,0,0,0,0,0,0,0
LAB North,HN-CBC,2024,CSD,Pepsi,Pull-Non-Working,All Other Non-Working,Agency out of pocket,0,0,0,0,0,0,0
LAB North,HN-CBC,2024,CSD,Pepsi,Pull-Non-Working,All Other Non-Working,CP out of pocket admin,0,0,0,0,0,0,0
LAB North,HN-CBC,2024,CSD,Pepsi,Pull-Non-Working,All Other Non-Working,Grassroots/experiential out of pocket,0,0,0,0,0,0,0
LAB North,HN-CBC,2024,CSD,Pepsi,Pull-Non-Working,All Other Non-Working,League/property- rights fee/options,0,0,0,0,0,0,0
LAB North,HN-CBC,2024,CSD,Pepsi,Pull-Non-Working,All Other Non-Working,Market Research,0,0,0,0,0,0,0
LAB North,HN-CBC,2024,CSD,Pepsi,Pull-Non-Working,All Other Non-Working,Non-allocated NW,0,0,0,0,0,0,0
LAB North,HN-CBC,2024,CSD,Pepsi,Pull-Non-Working,All Other Non-Working,Other Non Working-non itemised talent,0,0,0,0,0,0,0
LAB North,HN-CBC,2024,CSD,Pepsi,Pull-Non-Working,All Other Non-Working,PR out of pocket administrative,0,0,0,0,0,0,0
LAB North,HN-CBC,2024,CSD,Pepsi,Pull-Non-Working,Innovation and Insight,Innovations,0,0,0,0,0,0,0
LAB North,HN-CBC,2024,CSD,Pepsi,Pull-Non-Working,Innovation and Insight,Market Research,50,6912573,3553413,3359160,280744,144316,136428
LAB North,HN-CBC,2024,CSD,Pepsi,Pull-Non-Working,Package Design,Package design,0,0,0,0,0,0,0
LAB North,HN-CBC,2024,CSD,Pepsi,Pull-Non-Working,Package Design,Package development,0,0,0,0,0,0,0
LAB North,HN-CBC,2024,CSD,Pepsi,STB - Push,Capability Building/Other,Capability Building Other,0,0,0,0,0,0,0
LAB North,HN-CBC,2024,CSD,Pepsi,STB - Push,Other Investments,CDA's,50,6021635,3043703,2977932,244560,123615,120945
LAB North,HN-CBC,2024,CSD,Pepsi,STB - Push,Other Investments,Capital (Coolers),0,0,0,0,0,0,0
LAB North,HN-CBC,2024,CSD,Pepsi,STB - Push,Other Investments,Price Support,50,129483254,65508464,63974790,5258783,2660535,2598248
LAB North,HN-CBC,2024,CSD,Pepsi,STB - Push,Other Investments,Vending / Racks,0,0,0,0,0,0,0
LAB North,HN-CBC,2024,CSD,Pepsi,STB - Push,Other Trade,Frozen Funds,0,0,0,0,0,0,0
LAB North,HN-CBC,2024,CSD,Pepsi,STB - Push,Other Trade,Other Trade,50,11079355,5481133,5598222,449972,222608,227364
LAB North,HN-CBC,2024,CSD,Pepsi,STB - Push,Trade Equipment,Coolers - New,50,24723513,12498084,12225429,1004111,507592,496519
LAB North,HN-CBC,2024,CSD,Pepsi,STB - Push,Trade Equipment,Coolers - Refurbished,0,0,0,0,0,0,0
LAB North,HN-CBC,2024,CSD,Pepsi,STB - Push,Trade Equipment,Post Mix / Pre Mix Equip.,50,4410159,2257979,2152180,179112,91704,87408
LAB North,HN-CBC,2024,CSD,Pepsi,STB - Push,Trade Equipment,Vending / Racks,50,4224124,2003716,2220408,171556,81378,90178
LAB North,HN-CBC,2024,CSD,Pepsi,STB - Push,Trade Programs,Distribution Incentives,0,0,0,0,0,0,0
LAB North,HN-CBC,2024,CSD,Pepsi,STB - Push,Trade Programs,Innovation Investments,0,0,0,0,0,0,0
LAB North,HN-CBC,2024,CSD,Pepsi,STB - Push,Trade Programs,Sales Incentives,50,1853050,926215,926835,75259,37616,37643
LAB North,HN-CBC,2024,CSD,Pepsi,STB - Push,Trade Programs,Space Investments,0,0,0,0,0,0,0
LAB North,HN-CBC,2024,CSD,Pepsi,Pull-Working,All Other Working,Other Working - PR execution,50,465795,228863,236932,18917,9294,9623
LAB North,HN-CBC,2024,CSD,Pepsi,Pull-Working,All Other Working,Other Working - activation,0,0,0,0,0,0,0
LAB North,HN-CBC,2024,CSD,Pepsi,Pull-Working,All Other Working,Other Working - non allocated working,0,0,0,0,0,0,0
LAB North,HN-CBC,2024,CSD,Pepsi,Pull-Working,Consumer Promotions,Consumer Promotions Execution,50,5031598,2497089,2534509,204351,101415,102936
LAB North,HN-CBC,2024,CSD,Pepsi,Pull-Working,Consumer Promotions,Coupons,0,0,0,0,0,0,0
LAB North,HN-CBC,2024,CSD,Pepsi,Pull-Working,Consumer Promotions,Other,0,0,0,0,0,0,0
LAB North,HN-CBC,2024,CSD,Pepsi,Pull-Working,Consumer Promotions,Premiums,50,2348808,1188768,1160040,95393,48280,47113
LAB North,HN-CBC,2024,CSD,Pepsi,Pull-Working,In Store & POS Execution,In-Store & POS Execution,50,9193336,4913637,4279699,373374,199560,173814
LAB North,HN-CBC,2024,CSD,Pepsi,Pull-Working,Media Placements,Cinema,50,492430,242351,250079,19999,9842,10157
LAB North,HN-CBC,2024,CSD,Pepsi,Pull-Working,Media Placements,Digital,50,12667910,6298647,6369263,514489,255810,258679
LAB North,HN-CBC,2024,CSD,Pepsi,Pull-Working,Media Placements,OOH - Out Of Home,50,7952239,4068647,3883592,322969,165242,157727
LAB North,HN-CBC,2024,CSD,Pepsi,Pull-Working,Media Placements,Other,50,727405,358507,368898,29542,14560,14982
LAB North,HN-CBC,2024,CSD,Pepsi,Pull-Working,Media Placements,Print,0,0,0,0,0,0,0
LAB North,HN-CBC,2024,CSD,Pepsi,Pull-Working,Media Placements,Radio,50,1009688,495659,514029,41007,20130,20877
LAB North,HN-CBC,2024,CSD,Pepsi,Pull-Working,Media Placements,TV,50,4703433,2349937,2353496,191023,95439,95584
LAB North,HN-CBC,2024,CSD,Pepsi,Pull-Working,Sampling,Product Samples,50,152485,76116,76369,6192,3091,3101
LAB North,HN-CBC,2024,CSD,Pepsi,Pull-Working,Sampling,Sampling Execution,50,915872,439756,476116,37196,17860,19336
LAB North,HN-CBC,2024,CSD,Pepsi,Pull-Working,Sponsorships,Sponsorships-in game/ in show,50,8595588,4240517,4355071,349097,172222,176875
LAB North,HN-CBC,2024,CSD,Pepsi,Pull-Working,Sponsorships,Sports-athlete/team contracts,50,2525498,1231490,1294008,102569,50015,52554
LAB North,HN-CBC,2024,CSD,Pepsi,Pull-Working,Sponsorships,Sports-on field or in show props,0,0,0,0,0,0,0
LAB North,HN-CBC,2024,CSD,Pepsi,Pull-Working,Sponsorships,Sports-stadium contracts,0,0,0,0,0,0,0
LAB North,Jamaica,2024,Energy Drinks,Adrenaline,Pull-Non-Working,Ad Production,Digital Ad Production,0,0,0,0,0,0,0
LAB North,Jamaica,2024,Energy Drinks,Adrenaline,Pull-Non-Working,Ad Production,"TV, Print, Radio, OOH, Production",50,1371,697,674,8,4,4
LAB North,Jamaica,2024,Energy Drinks,Adrenaline,Pull-Non-Working,Agency Fees,Creative Agency Fees,0,0,0,0,0,0,0
LAB North,Jamaica,2024,Energy Drinks,Adrenaline,Pull-Non-Working,Agency Fees,In Store & POS Design / Development,0,0,0,0,0,0,0
LAB North,Jamaica,2024,Energy Drinks,Adrenaline,Pull-Non-Working,Agency Fees,Media Agency Fees,0,0,0,0,0,0,0
LAB North,Jamaica,2024,Energy Drinks,Adrenaline,Pull-Non-Working,Agency Fees,Other,0,0,0,0,0,0,0
LAB North,Jamaica,2024,Energy Drinks,Adrenaline,Pull-Non-Working,Agency Fees,Social Media / Influence Marketing,50,9800,4827,4973,63,31,32
LAB North,Jamaica,2024,Energy Drinks,Adrenaline,Pull-Non-Working,All Other Non-Working,Administrative fees,0,0,0,0,0,0,0
LAB North,Jamaica,2024,Energy Drinks,Adrenaline,Pull-Non-Working,All Other Non-Working,Agency out of pocket,0,0,0,0,0,0,0
LAB North,Jamaica,2024,Energy Drinks,Adrenaline,Pull-Non-Working,All Other Non-Working,CP out of pocket admin,0,0,0,0,0,0,0
LAB North,Jamaica,2024,Energy Drinks,Adrenaline,Pull-Non-Working,All Other Non-Working,Grassroots/experiential out of pocket,0,0,0,0,0,0,0
LAB North,Jamaica,2024,Energy Drinks,Adrenaline,Pull-Non-Working,All Other Non-Working,League/property- rights fee/options,0,0,0,0,0,0,0
LAB North,Jamaica,2024,Energy Drinks,Adrenaline,Pull-Non-Working,All Other Non-Working,Market Research,0,0,0,0,0,0,0
LAB North,Jamaica,2024,Energy Drinks,Adrenaline,Pull-Non-Working,All Other Non-Working,Non-allocated NW,0,0,0,0,0,0,0
LAB North,Jamaica,2024,Energy Drinks,Adrenaline,Pull-Non-Working,All Other Non-Working,Other Non Working-non itemised talent,0,0,0,0,0,0,0
LAB North,Jamaica,2024,Energy Drinks,Adrenaline,Pull-Non-Working,All Other Non-Working,PR out of pocket administrative,0,0,0,0,0,0,0
LAB North,Jamaica,2024,Energy Drinks,Adrenaline,Pull-Non-Working,Innovation and Insight,Innovations,0,0,0,0,0,0,0
LAB North,Jamaica,2024,Energy Drinks,Adrenaline,Pull-Non-Working,Innovation and Insight,Market Research,50,2763,1375,1388,17,8,9
LAB North,Jamaica,2024,Energy Drinks,Adrenaline,Pull-Non-Working,Package Design,Package design,0,0,0,0,0,0,0
LAB North,Jamaica,2024,Energy Drinks,Adrenaline,Pull-Non-Working,Package Design,Package development,0,0,0,0,0,0,0
LAB North,Jamaica,2024,Energy Drinks,Adrenaline,STB - Push,Capability Building/Other,Capability Building Other,0,0,0,0,0,0,0
LAB North,Jamaica,2024,Energy Drinks,Adrenaline,STB - Push,Other Investments,CDA's,0,0,0,0,0,0,0
LAB North,Jamaica,2024,Energy Drinks,Adrenaline,STB - Push,Other Investments,Capital (Coolers),0,0,0,0,0,0,0
LAB North,Jamaica,2024,Energy Drinks,Adrenaline,STB - Push,Other Investments,Price Support,50,498446,237649,260797,3205,1528,1677
LAB North,Jamaica,2024,Energy Drinks,Adrenaline,STB - Push,Other Investments,Vending / Racks,0,0,0,0,0,0,0
LAB North,Jamaica,2024,Energy Drinks,Adrenaline,STB - Push,Other Trade,Frozen Funds,0,0,0,0,0,0,0
LAB North,Jamaica,2024,Energy Drinks,Adrenaline,STB - Push,Other Trade,Other Trade,0,0,0,0,0,0,0
LAB North,Jamaica,2024,Energy Drinks,Adrenaline,STB - Push,Trade Equipment,Coolers - New,0,0,0,0,0,0,0
LAB North,Jamaica,2024,Energy Drinks,Adrenaline,STB - Push,Trade Equipment,Coolers - Refurbished,0,0,0,0,0,0,0
LAB North,Jamaica,2024,Energy Drinks,Adrenaline,STB - Push,Trade Equipment,Post Mix / Pre Mix Equip.,0,0,0,0,0,0,0
LAB North,Jamaica,2024,Energy Drinks,Adrenaline,STB - Push,Trade Equipment,Vending / Racks,0,0,0,0,0,0,0
LAB North,Jamaica,2024,Energy Drinks,Adrenaline,STB - Push,Trade Programs,Distribution Incentives,0,0,0,0,0,0,0
LAB North,Jamaica,2024,Energy Drinks,Adrenaline,STB - Push,Trade Programs,Innovation Investments,0,0,0,0,0,0,0
LAB North,Jamaica,2024,Energy Drinks,Adrenaline,STB - Push,Trade Programs,Sales Incentives,0,0,0,0,0,0,0
LAB North,Jamaica,2024,Energy Drinks,Adrenaline,STB - Push,Trade Programs,Space Investments,0,0,0,0,0,0,0
LAB North,Jamaica,2024,Energy Drinks,Adrenaline,Pull-Working,All Other Working,Other Working - PR execution,0,0,0,0,0,0,0
LAB North,Jamaica,2024,Energy Drinks,Adrenaline,Pull-Working,All Other Working,Other Working - activation,0,0,0,0,0,0,0
LAB North,Jamaica,2024,Energy Drinks,Adrenaline,Pull-Working,All Other Working,Other Working - non allocated working,0,0,0,0,0,0,0
LAB North,Jamaica,2024,Energy Drinks,Adrenaline,Pull-Working,Consumer Promotions,Consumer Promotions Execution,0,0,0,0,0,0,0
LAB North,Jamaica,2024,Energy Drinks,Adrenaline,Pull-Working,Consumer Promotions,Coupons,0,0,0,0,0,0,0
LAB North,Jamaica,2024,Energy Drinks,Adrenaline,Pull-Working,Consumer Promotions,Other,0,0,0,0,0,0,0
LAB North,Jamaica,2024,Energy Drinks,Adrenaline,Pull-Working,Consumer Promotions,Premiums,0,0,0,0,0,0,0
LAB North,Jamaica,2024,Energy Drinks,Adrenaline,Pull-Working,In Store & POS Execution,In-Store & POS Execution,50,12684,6400,6284,81,41,40
LAB North,Jamaica,2024,Energy Drinks,Adrenaline,Pull-Working,Media Placements,Cinema,0,0,0,0,0,0,0
LAB North,Jamaica,2024,Energy Drinks,Adrenaline,Pull-Working,Media Placements,Digital,50,26804,13307,13497,172,85,87
LAB North,Jamaica,2024,Energy Drinks,Adrenaline,Pull-Working,Media Placements,OOH - Out Of Home,50,15521,7669,7852,99,49,50
LAB North,Jamaica,2024,Energy Drinks,Adrenaline,Pull-Working,Media Placements,Other,0,0,0,0,0,0,0
LAB North,Jamaica,2024,Energy Drinks,Adrenaline,Pull-Working,Media Placements,Print,0,0,0,0,0,0,0
LAB North,Jamaica,2024,Energy Drinks,Adrenaline,Pull-Working,Media Placements,Radio,50,23153,11833,11320,148,76,72
LAB North,Jamaica,2024,Energy Drinks,Adrenaline,Pull-Working,Media Placements,TV,0,0,0,0,0,0,0
LAB North,Jamaica,2024,Energy Drinks,Adrenaline,Pull-Working,Sampling,Product Samples,0,0,0,0,0,0,0
LAB North,Jamaica,2024,Energy Drinks,Adrenaline,Pull-Working,Sampling,Sampling Execution,0,0,0,0,0,0,0
LAB North,Jamaica,2024,Energy Drinks,Adrenaline,Pull-Working,Sponsorships,Sponsorships-in game/ in show,50,26192,13044,13148,168,83,85
LAB North,Jamaica,2024,Energy Drinks,Adrenaline,Pull-Working,Sponsorships,Sports-athlete/team contracts,0,0,0,0,0,0,0
LAB North,Jamaica,2024,Energy Drinks,Adrenaline,Pull-Working,Sponsorships,Sports-on field or in show props,0,0,0,0,0,0,0
LAB North,Jamaica,2024,Energy Drinks,Adrenaline,Pull-Working,Sponsorships,Sports-stadium contracts,0,0,0,0,0,0,0
LAB North,Jamaica,2024,CSD,D&G,Pull-Non-Working,Ad Production,Digital Ad Production,0,0,0,0,0,0,0
LAB North,Jamaica,2024,CSD,D&G,Pull-Non-Working,Ad Production,"TV, Print, Radio, OOH, Production",0,0,0,0,0,0,0
LAB North,Jamaica,2024,CSD,D&G,Pull-Non-Working,Agency Fees,Creative Agency Fees,0,0,0,0,0,0,0
LAB North,Jamaica,2024,CSD,D&G,Pull-Non-Working,Agency Fees,In Store & POS Design / Development,0,0,0,0,0,0,0
LAB North,Jamaica,2024,CSD,D&G,Pull-Non-Working,Agency Fees,Media Agency Fees,0,0,0,0,0,0,0
LAB North,Jamaica,2024,CSD,D&G,Pull-Non-Working,Agency Fees,Other,0,0,0,0,0,0,0
LAB North,Jamaica,2024,CSD,D&G,Pull-Non-Working,Agency Fees,Social Media / Influence Marketing,0,0,0,0,0,0,0
LAB North,Jamaica,2024,CSD,D&G,Pull-Non-Working,All Other Non-Working,Administrative fees,0,0,0,0,0,0,0
LAB North,Jamaica,2024,CSD,D&G,Pull-Non-Working,All Other Non-Working,Agency out of pocket,0,0,0,0,0,0,0
LAB North,Jamaica,2024,CSD,D&G,Pull-Non-Working,All Other Non-Working,CP out of pocket admin,0,0,0,0,0,0,0
LAB North,Jamaica,2024,CSD,D&G,Pull-Non-Working,All Other Non-Working,Grassroots/experiential out of pocket,0,0,0,0,0,0,0
LAB North,Jamaica,2024,CSD,D&G,Pull-Non-Working,All Other Non-Working,League/property- rights fee/options,0,0,0,0,0,0,0
LAB North,Jamaica,2024,CSD,D&G,Pull-Non-Working,All Other Non-Working,Market Research,0,0,0,0,0,0,0
LAB North,Jamaica,2024,CSD,D&G,Pull-Non-Working,All Other Non-Working,Non-allocated NW,0,0,0,0,0,0,0
LAB North,Jamaica,2024,CSD,D&G,Pull-Non-Working,All Other Non-Working,Other Non Working-non itemised talent,0,0,0,0,0,0,0
LAB North,Jamaica,2024,CSD,D&G,Pull-Non-Working,All Other Non-Working,PR out of pocket administrative,0,0,0,0,0,0,0
LAB North,Jamaica,2024,CSD,D&G,Pull-Non-Working,Innovation and Insight,Innovations,0,0,0,0,0,0,0
LAB North,Jamaica,2024,CSD,D&G,Pull-Non-Working,Innovation and Insight,Market Research,0,0,0,0,0,0,0
LAB North,Jamaica,2024,CSD,D&G,Pull-Non-Working,Package Design,Package design,0,0,0,0,0,0,0
LAB North,Jamaica,2024,CSD,D&G,Pull-Non-Working,Package Design,Package development,0,0,0,0,0,0,0
LAB North,Jamaica,2024,CSD,D&G,STB - Push,Capability Building/Other,Capability Building Other,0,0,0,0,0,0,0
LAB North,Jamaica,2024,CSD,D&G,STB - Push,Other Investments,CDA's,0,0,0,0,0,0,0
LAB North,Jamaica,2024,CSD,D&G,STB - Push,Other Investments,Capital (Coolers),0,0,0,0,0,0,0
LAB North,Jamaica,2024,CSD,D&G,STB - Push,Other Investments,Price Support,50,297296,149975,147321,1911,964,947
LAB North,Jamaica,2024,CSD,D&G,STB - Push,Other Investments,Vending / Racks,0,0,0,0,0,0,0
LAB North,Jamaica,2024,CSD,D&G,STB - Push,Other Trade,Frozen Funds,0,0,0,0,0,0,0
LAB North,Jamaica,2024,CSD,D&G,STB - Push,Other Trade,Other Trade,0,0,0,0,0,0,0
LAB North,Jamaica,2024,CSD,D&G,STB - Push,Trade Equipment,Coolers - New,0,0,0,0,0,0,0
LAB North,Jamaica,2024,CSD,D&G,STB - Push,Trade Equipment,Coolers - Refurbished,0,0,0,0,0,0,0
LAB North,Jamaica,2024,CSD,D&G,STB - Push,Trade Equipment,Post Mix / Pre Mix Equip.,0,0,0,0,0,0,0
LAB North,Jamaica,2024,CSD,D&G,STB - Push,Trade Equipment,Vending / Racks,0,0,0,0,0,0,0
LAB North,Jamaica,2024,CSD,D&G,STB - Push,Trade Programs,Distribution Incentives,0,0,0,0,0,0,0
LAB North,Jamaica,2024,CSD,D&G,STB - Push,Trade Programs,Innovation Investments,0,0,0,0,0,0,0
LAB North,Jamaica,2024,CSD,D&G,STB - Push,Trade Programs,Sales Incentives,0,0,0,0,0,0,0
LAB North,Jamaica,2024,CSD,D&G,STB - Push,Trade Programs,Space Investments,0,0,0,0,0,0,0
LAB North,Jamaica,2024,CSD,D&G,Pull-Working,All Other Working,Other Working - PR execution,0,0,0,0,0,0,0
LAB North,Jamaica,2024,CSD,D&G,Pull-Working,All Other Working,Other Working - activation,0,0,0,0,0,0,0
LAB North,Jamaica,2024,CSD,D&G,Pull-Working,All Other Working,Other Working - non allocated working,0,0,0,0,0,0,0
LAB North,Jamaica,2024,CSD,D&G,Pull-Working,Consumer Promotions,Consumer Promotions Execution,0,0,0,0,0,0,0
LAB North,Jamaica,2024,CSD,D&G,Pull-Working,Consumer Promotions,Coupons,0,0,0,0,0,0,0
LAB North,Jamaica,2024,CSD,D&G,Pull-Working,Consumer Promotions,Other,0,0,0,0,0,0,0
LAB North,Jamaica,2024,CSD,D&G,Pull-Working,Consumer Promotions,Premiums,0,0,0,0,0,0,0
LAB North,Jamaica,2024,CSD,D&G,Pull-Working,In Store & POS Execution,In-Store & POS Execution,0,0,0,0,0,0,0
LAB North,Jamaica,2024,CSD,D&G,Pull-Working,Media Placements,Cinema,0,0,0,0,0,0,0
LAB North,Jamaica,2024,CSD,D&G,Pull-Working,Media Placements,Digital,0,0,0,0,0,0,0
LAB North,Jamaica,2024,CSD,D&G,Pull-Working,Media Placements,OOH - Out Of Home,0,0,0,0,0,0,0
LAB North,Jamaica,2024,CSD,D&G,Pull-Working,Media Placements,Other,0,0,0,0,0,0,0
LAB North,Jamaica,2024,CSD,D&G,Pull-Working,Media Placements,Print,0,0,0,0,0,0,0
LAB North,Jamaica,2024,CSD,D&G,Pull-Working,Media Placements,Radio,0,0,0,0,0,0,0
LAB North,Jamaica,2024,CSD,D&G,Pull-Working,Media Placements,TV,0,0,0,0,0,0,0
LAB North,Jamaica,2024,CSD,D&G,Pull-Working,Sampling,Product Samples,0,0,0,0,0,0,0
LAB North,Jamaica,2024,CSD,D&G,Pull-Working,Sampling,Sampling Execution,0,0,0,0,0,0,0
LAB North,Jamaica,2024,CSD,D&G,Pull-Working,Sponsorships,Sponsorships-in game/ in show,0,0,0,0,0,0,0
LAB North,Jamaica,2024,CSD,D&G,Pull-Working,Sponsorships,Sports-athlete/team contracts,0,0,0,0,0,0,0
LAB North,Jamaica,2024,CSD,D&G,Pull-Working,Sponsorships,Sports-on field or in show props,0,0,0,0,0,0,0
LAB North,Jamaica,2024,CSD,D&G,Pull-Working,Sponsorships,Sports-stadium contracts,0,0,0,0,0,0,0
LAB North,Jamaica,2024,Sport Drinks,Gatorade,Pull-Non-Working,Ad Production,Digital Ad Production,50,10886,5553,5333,70,35,35
LAB North,Jamaica,2024,Sport Drinks,Gatorade,Pull-Non-Working,Ad Production,"TV, Print, Radio, OOH, Production",0,0,0,0,0,0,0
LAB North,Jamaica,2024,Sport Drinks,Gatorade,Pull-Non-Working,Agency Fees,Creative Agency Fees,0,0,0,0,0,0,0
LAB North,Jamaica,2024,Sport Drinks,Gatorade,Pull-Non-Working,Agency Fees,In Store & POS Design / Development,0,0,0,0,0,0,0
LAB North,Jamaica,2024,Sport Drinks,Gatorade,Pull-Non-Working,Agency Fees,Media Agency Fees,0,0,0,0,0,0,0
LAB North,Jamaica,2024,Sport Drinks,Gatorade,Pull-Non-Working,Agency Fees,Other,0,0,0,0,0,0,0
LAB North,Jamaica,2024,Sport Drinks,Gatorade,Pull-Non-Working,Agency Fees,Social Media / Influence Marketing,50,46034,23751,22283,296,152,144
LAB North,Jamaica,2024,Sport Drinks,Gatorade,Pull-Non-Working,All Other Non-Working,Administrative fees,0,0,0,0,0,0,0
LAB North,Jamaica,2024,Sport Drinks,Gatorade,Pull-Non-Working,All Other Non-Working,Agency out of pocket,0,0,0,0,0,0,0
LAB North,Jamaica,2024,Sport Drinks,Gatorade,Pull-Non-Working,All Other Non-Working,CP out of pocket admin,0,0,0,0,0,0,0
LAB North,Jamaica,2024,Sport Drinks,Gatorade,Pull-Non-Working,All Other Non-Working,Grassroots/experiential out of pocket,0,0,0,0,0,0,0
LAB North,Jamaica,2024,Sport Drinks,Gatorade,Pull-Non-Working,All Other Non-Working,League/property- rights fee/options,0,0,0,0,0,0,0
LAB North,Jamaica,2024,Sport Drinks,Gatorade,Pull-Non-Working,All Other Non-Working,Market Research,0,0,0,0,0,0,0
LAB North,Jamaica,2024,Sport Drinks,Gatorade,Pull-Non-Working,All Other Non-Working,Non-allocated NW,0,0,0,0,0,0,0
LAB North,Jamaica,2024,Sport Drinks,Gatorade,Pull-Non-Working,All Other Non-Working,Other Non Working-non itemised talent,0,0,0,0,0,0,0
LAB North,Jamaica,2024,Sport Drinks,Gatorade,Pull-Non-Working,All Other Non-Working,PR out of pocket administrative,0,0,0,0,0,0,0
LAB North,Jamaica,2024,Sport Drinks,Gatorade,Pull-Non-Working,Innovation and Insight,Innovations,0,0,0,0,0,0,0
LAB North,Jamaica,2024,Sport Drinks,Gatorade,Pull-Non-Working,Innovation and Insight,Market Research,50,6972,3434,3538,44,22,22
LAB North,Jamaica,2024,Sport Drinks,Gatorade,Pull-Non-Working,Package Design,Package design,0,0,0,0,0,0,0
LAB North,Jamaica,2024,Sport Drinks,Gatorade,Pull-Non-Working,Package Design,Package development,0,0,0,0,0,0,0
LAB North,Jamaica,2024,Sport Drinks,Gatorade,STB - Push,Capability Building/Other,Capability Building Other,0,0,0,0,0,0,0
LAB North,Jamaica,2024,Sport Drinks,Gatorade,STB - Push,Other Investments,CDA's,0,0,0,0,0,0,0
LAB North,Jamaica,2024,Sport Drinks,Gatorade,STB - Push,Other Investments,Capital (Coolers),0,0,0,0,0,0,0
LAB North,Jamaica,2024,Sport Drinks,Gatorade,STB - Push,Other Investments,Price Support,50,510751,261332,249419,3284,1680,1604
LAB North,Jamaica,2024,Sport Drinks,Gatorade,STB - Push,Other Investments,Vending / Racks,0,0,0,0,0,0,0
LAB North,Jamaica,2024,Sport Drinks,Gatorade,STB - Push,Other Trade,Frozen Funds,0,0,0,0,0,0,0
LAB North,Jamaica,2024,Sport Drinks,Gatorade,STB - Push,Other Trade,Other Trade,0,0,0,0,0,0,0
LAB North,Jamaica,2024,Sport Drinks,Gatorade,STB - Push,Trade Equipment,Coolers - New,0,0,0,0,0,0,0
LAB North,Jamaica,2024,Sport Drinks,Gatorade,STB - Push,Trade Equipment,Coolers - Refurbished,0,0,0,0,0,0,0
LAB North,Jamaica,2024,Sport Drinks,Gatorade,STB - Push,Trade Equipment,Post Mix / Pre Mix Equip.,0,0,0,0,0,0,0
LAB North,Jamaica,2024,Sport Drinks,Gatorade,STB - Push,Trade Equipment,Vending / Racks,0,0,0,0,0,0,0
LAB North,Jamaica,2024,Sport Drinks,Gatorade,STB - Push,Trade Programs,Distribution Incentives,50,112675,58690,53985,724,377,347
LAB North,Jamaica,2024,Sport Drinks,Gatorade,STB - Push,Trade Programs,Innovation Investments,0,0,0,0,0,0,0
LAB North,Jamaica,2024,Sport Drinks,Gatorade,STB - Push,Trade Programs,Sales Incentives,50,129544,63477,66067,833,408,425
LAB North,Jamaica,2024,Sport Drinks,Gatorade,STB - Push,Trade Programs,Space Investments,50,72306,36223,36083,465,232,233
LAB North,Jamaica,2024,Sport Drinks,Gatorade,Pull-Working,All Other Working,Other Working - PR execution,50,9233,4424,4809,59,28,31
LAB North,Jamaica,2024,Sport Drinks,Gatorade,Pull-Working,All Other Working,Other Working - activation,0,0,0,0,0,0,0
LAB North,Jamaica,2024,Sport Drinks,Gatorade,Pull-Working,All Other Working,Other Working - non allocated working,0,0,0,0,0,0,0
LAB North,Jamaica,2024,Sport Drinks,Gatorade,Pull-Working,Consumer Promotions,Consumer Promotions Execution,50,36058,17966,18092,231,115,116
LAB North,Jamaica,2024,Sport Drinks,Gatorade,Pull-Working,Consumer Promotions,Coupons,0,0,0,0,0,0,0
LAB North,Jamaica,2024,Sport Drinks,Gatorade,Pull-Working,Consumer Promotions,Other,0,0,0,0,0,0,0
LAB North,Jamaica,2024,Sport Drinks,Gatorade,Pull-Working,Consumer Promotions,Premiums,50,11877,5987,5890,76,38,38
LAB North,Jamaica,2024,Sport Drinks,Gatorade,Pull-Working,In Store & POS Execution,In-Store & POS Execution,50,33307,16609,16698,214,106,108
LAB North,Jamaica,2024,Sport Drinks,Gatorade,Pull-Working,Media Placements,Cinema,0,0,0,0,0,0,0
LAB North,Jamaica,2024,Sport Drinks,Gatorade,Pull-Working,Media Placements,Digital,50,85503,44535,40968,549,286,263
LAB North,Jamaica,2024,Sport Drinks,Gatorade,Pull-Working,Media Placements,OOH - Out Of Home,50,12225,6008,6217,78,38,40
LAB North,Jamaica,2024,Sport Drinks,Gatorade,Pull-Working,Media Placements,Other,0,0,0,0,0,0,0
LAB North,Jamaica,2024,Sport Drinks,Gatorade,Pull-Working,Media Placements,Print,0,0,0,0,0,0,0
LAB North,Jamaica,2024,Sport Drinks,Gatorade,Pull-Working,Media Placements,Radio,50,48490,24272,24218,311,156,155
LAB North,Jamaica,2024,Sport Drinks,Gatorade,Pull-Working,Media Placements,TV,0,0,0,0,0,0,0
LAB North,Jamaica,2024,Sport Drinks,Gatorade,Pull-Working,Sampling,Product Samples,0,0,0,0,0,0,0
LAB North,Jamaica,2024,Sport Drinks,Gatorade,Pull-Working,Sampling,Sampling Execution,0,0,0,0,0,0,0
LAB North,Jamaica,2024,Sport Drinks,Gatorade,Pull-Working,Sponsorships,Sponsorships-in game/ in show,50,94610,48934,45676,608,314,294
LAB North,Jamaica,2024,Sport Drinks,Gatorade,Pull-Working,Sponsorships,Sports-athlete/team contracts,0,0,0,0,0,0,0
LAB North,Jamaica,2024,Sport Drinks,Gatorade,Pull-Working,Sponsorships,Sports-on field or in show props,0,0,0,0,0,0,0
LAB North,Jamaica,2024,Sport Drinks,Gatorade,Pull-Working,Sponsorships,Sports-stadium contracts,0,0,0,0,0,0,0
LAB North,Jamaica,2024,Juices,Ocean Spray,Pull-Non-Working,Ad Production,Digital Ad Production,0,0,0,0,0,0,0
LAB North,Jamaica,2024,Juices,Ocean Spray,Pull-Non-Working,Ad Production,"TV, Print, Radio, OOH, Production",0,0,0,0,0,0,0
LAB North,Jamaica,2024,Juices,Ocean Spray,Pull-Non-Working,Agency Fees,Creative Agency Fees,0,0,0,0,0,0,0
LAB North,Jamaica,2024,Juices,Ocean Spray,Pull-Non-Working,Agency Fees,In Store & POS Design / Development,0,0,0,0,0,0,0
LAB North,Jamaica,2024,Juices,Ocean Spray,Pull-Non-Working,Agency Fees,Media Agency Fees,0,0,0,0,0,0,0
LAB North,Jamaica,2024,Juices,Ocean Spray,Pull-Non-Working,Agency Fees,Other,0,0,0,0,0,0,0
LAB North,Jamaica,2024,Juices,Ocean Spray,Pull-Non-Working,Agency Fees,Social Media / Influence Marketing,50,5244,2608,2636,33,16,17
LAB North,Jamaica,2024,Juices,Ocean Spray,Pull-Non-Working,All Other Non-Working,Administrative fees,0,0,0,0,0,0,0
LAB North,Jamaica,2024,Juices,Ocean Spray,Pull-Non-Working,All Other Non-Working,Agency out of pocket,0,0,0,0,0,0,0
LAB North,Jamaica,2024,Juices,Ocean Spray,Pull-Non-Working,All Other Non-Working,CP out of pocket admin,0,0,0,0,0,0,0
LAB North,Jamaica,2024,Juices,Ocean Spray,Pull-Non-Working,All Other Non-Working,Grassroots/experiential out of pocket,0,0,0,0,0,0,0
LAB North,Jamaica,2024,Juices,Ocean Spray,Pull-Non-Working,All Other Non-Working,League/property- rights fee/options,0,0,0,0,0,0,0
LAB North,Jamaica,2024,Juices,Ocean Spray,Pull-Non-Working,All Other Non-Working,Market Research,0,0,0,0,0,0,0
LAB North,Jamaica,2024,Juices,Ocean Spray,Pull-Non-Working,All Other Non-Working,Non-allocated NW,0,0,0,0,0,0,0
LAB North,Jamaica,2024,Juices,Ocean Spray,Pull-Non-Working,All Other Non-Working,Other Non Working-non itemised talent,0,0,0,0,0,0,0
LAB North,Jamaica,2024,Juices,Ocean Spray,Pull-Non-Working,All Other Non-Working,PR out of pocket administrative,0,0,0,0,0,0,0
LAB North,Jamaica,2024,Juices,Ocean Spray,Pull-Non-Working,Innovation and Insight,Innovations,0,0,0,0,0,0,0
LAB North,Jamaica,2024,Juices,Ocean Spray,Pull-Non-Working,Innovation and Insight,Market Research,50,9744,4706,5038,62,30,32
LAB North,Jamaica,2024,Juices,Ocean Spray,Pull-Non-Working,Package Design,Package design,0,0,0,0,0,0,0
LAB North,Jamaica,2024,Juices,Ocean Spray,Pull-Non-Working,Package Design,Package development,0,0,0,0,0,0,0
LAB North,Jamaica,2024,Juices,Ocean Spray,STB - Push,Capability Building/Other,Capability Building Other,0,0,0,0,0,0,0
LAB North,Jamaica,2024,Juices,Ocean Spray,STB - Push,Other Investments,CDA's,0,0,0,0,0,0,0
LAB North,Jamaica,2024,Juices,Ocean Spray,STB - Push,Other Investments,Capital (Coolers),0,0,0,0,0,0,0
LAB North,Jamaica,2024,Juices,Ocean Spray,STB - Push,Other Investments,Price Support,50,544807,276382,268425,3503,1777,1726
LAB North,Jamaica,2024,Juices,Ocean Spray,STB - Push,Other Investments,Vending / Racks,0,0,0,0,0,0,0
LAB North,Jamaica,2024,Juices,Ocean Spray,STB - Push,Other Trade,Frozen Funds,0,0,0,0,0,0,0
LAB North,Jamaica,2024,Juices,Ocean Spray,STB - Push,Other Trade,Other Trade,0,0,0,0,0,0,0
LAB North,Jamaica,2024,Juices,Ocean Spray,STB - Push,Trade Equipment,Coolers - New,0,0,0,0,0,0,0
LAB North,Jamaica,2024,Juices,Ocean Spray,STB - Push,Trade Equipment,Coolers - Refurbished,0,0,0,0,0,0,0
LAB North,Jamaica,2024,Juices,Ocean Spray,STB - Push,Trade Equipment,Post Mix / Pre Mix Equip.,0,0,0,0,0,0,0
LAB North,Jamaica,2024,Juices,Ocean Spray,STB - Push,Trade Equipment,Vending / Racks,0,0,0,0,0,0,0
LAB North,Jamaica,2024,Juices,Ocean Spray,STB - Push,Trade Programs,Distribution Incentives,50,79769,40035,39734,513,257,256
LAB North,Jamaica,2024,Juices,Ocean Spray,STB - Push,Trade Programs,Innovation Investments,0,0,0,0,0,0,0
LAB North,Jamaica,2024,Juices,Ocean Spray,STB - Push,Trade Programs,Sales Incentives,0,0,0,0,0,0,0
LAB North,Jamaica,2024,Juices,Ocean Spray,STB - Push,Trade Programs,Space Investments,50,46515,23746,22769,299,152,147
LAB North,Jamaica,2024,Juices,Ocean Spray,Pull-Working,All Other Working,Other Working - PR execution,0,0,0,0,0,0,0
LAB North,Jamaica,2024,Juices,Ocean Spray,Pull-Working,All Other Working,Other Working - activation,0,0,0,0,0,0,0
LAB North,Jamaica,2024,Juices,Ocean Spray,Pull-Working,All Other Working,Other Working - non allocated working,0,0,0,0,0,0,0
LAB North,Jamaica,2024,Juices,Ocean Spray,Pull-Working,Consumer Promotions,Consumer Promotions Execution,0,0,0,0,0,0,0
LAB North,Jamaica,2024,Juices,Ocean Spray,Pull-Working,Consumer Promotions,Coupons,0,0,0,0,0,0,0
LAB North,Jamaica,2024,Juices,Ocean Spray,Pull-Working,Consumer Promotions,Other,0,0,0,0,0,0,0
LAB North,Jamaica,2024,Juices,Ocean Spray,Pull-Working,Consumer Promotions,Premiums,0,0,0,0,0,0,0
LAB North,Jamaica,2024,Juices,Ocean Spray,Pull-Working,In Store & POS Execution,In-Store & POS Execution,50,16995,8868,8127,109,57,52
LAB North,Jamaica,2024,Juices,Ocean Spray,Pull-Working,Media Placements,Cinema,0,0,0,0,0,0,0
LAB North,Jamaica,2024,Juices,Ocean Spray,Pull-Working,Media Placements,Digital,50,31086,15784,15302,199,101,98
LAB North,Jamaica,2024,Juices,Ocean Spray,Pull-Working,Media Placements,OOH - Out Of Home,0,0,0,0,0,0,0
LAB North,Jamaica,2024,Juices,Ocean Spray,Pull-Working,Media Placements,Other,0,0,0,0,0,0,0
LAB North,Jamaica,2024,Juices,Ocean Spray,Pull-Working,Media Placements,Print,0,0,0,0,0,0,0
LAB North,Jamaica,2024,Juices,Ocean Spray,Pull-Working,Media Placements,Radio,50,9533,4964,4569,61,31,30
LAB North,Jamaica,2024,Juices,Ocean Spray,Pull-Working,Media Placements,TV,0,0,0,0,0,0,0
LAB North,Jamaica,2024,Juices,Ocean Spray,Pull-Working,Sampling,Product Samples,50,7522,3889,3633,48,25,23
LAB North,Jamaica,2024,Juices,Ocean Spray,Pull-Working,Sampling,Sampling Execution,50,1491,777,714,9,4,5
LAB North,Jamaica,2024,Juices,Ocean Spray,Pull-Working,Sponsorships,Sponsorships-in game/ in show,0,0,0,0,0,0,0
LAB North,Jamaica,2024,Juices,Ocean Spray,Pull-Working,Sponsorships,Sports-athlete/team contracts,0,0,0,0,0,0,0
LAB North,Jamaica,2024,Juices,Ocean Spray,Pull-Working,Sponsorships,Sports-on field or in show props,0,0,0,0,0,0,0
LAB North,Jamaica,2024,Juices,Ocean Spray,Pull-Working,Sponsorships,Sports-stadium contracts,0,0,0,0,0,0,0
LAB North,Jamaica,2024,CSD,Pepsi,Pull-Non-Working,Ad Production,Digital Ad Production,0,0,0,0,0,0,0
LAB North,Jamaica,2024,CSD,Pepsi,Pull-Non-Working,Ad Production,"TV, Print, Radio, OOH, Production",50,117206,58054,59152,753,373,380
LAB North,Jamaica,2024,CSD,Pepsi,Pull-Non-Working,Agency Fees,Creative Agency Fees,0,0,0,0,0,0,0
LAB North,Jamaica,2024,CSD,Pepsi,Pull-Non-Working,Agency Fees,In Store & POS Design / Development,0,0,0,0,0,0,0
LAB North,Jamaica,2024,CSD,Pepsi,Pull-Non-Working,Agency Fees,Media Agency Fees,0,0,0,0,0,0,0
LAB North,Jamaica,2024,CSD,Pepsi,Pull-Non-Working,Agency Fees,Other,50,86411,40902,45509,555,263,292
LAB North,Jamaica,2024,CSD,Pepsi,Pull-Non-Working,Agency Fees,Social Media / Influence Marketing,50,45921,22822,23099,295,146,149
LAB North,Jamaica,2024,CSD,Pepsi,Pull-Non-Working,All Other Non-Working,Administrative fees,0,0,0,0,0,0,0
LAB North,Jamaica,2024,CSD,Pepsi,Pull-Non-Working,All Other Non-Working,Agency out of pocket,0,0,0,0,0,0,0
LAB North,Jamaica,2024,CSD,Pepsi,Pull-Non-Working,All Other Non-Working,CP out of pocket admin,0,0,0,0,0,0,0
LAB North,Jamaica,2024,CSD,Pepsi,Pull-Non-Working,All Other Non-Working,Grassroots/experiential out of pocket,0,0,0,0,0,0,0
LAB North,Jamaica,2024,CSD,Pepsi,Pull-Non-Working,All Other Non-Working,League/property- rights fee/options,0,0,0,0,0,0,0
LAB North,Jamaica,2024,CSD,Pepsi,Pull-Non-Working,All Other Non-Working,Market Research,0,0,0,0,0,0,0
LAB North,Jamaica,2024,CSD,Pepsi,Pull-Non-Working,All Other Non-Working,Non-allocated NW,0,0,0,0,0,0,0
LAB North,Jamaica,2024,CSD,Pepsi,Pull-Non-Working,All Other Non-Working,Other Non Working-non itemised talent,0,0,0,0,0,0,0
LAB North,Jamaica,2024,CSD,Pepsi,Pull-Non-Working,All Other Non-Working,PR out of pocket administrative,0,0,0,0,0,0,0
LAB North,Jamaica,2024,CSD,Pepsi,Pull-Non-Working,Innovation and Insight,Innovations,0,0,0,0,0,0,0
LAB North,Jamaica,2024,CSD,Pepsi,Pull-Non-Working,Innovation and Insight,Market Research,50,38638,19159,19479,248,123,125
LAB North,Jamaica,2024,CSD,Pepsi,Pull-Non-Working,Package Design,Package design,0,0,0,0,0,0,0
LAB North,Jamaica,2024,CSD,Pepsi,Pull-Non-Working,Package Design,Package development,0,0,0,0,0,0,0
LAB North,Jamaica,2024,CSD,Pepsi,STB - Push,Capability Building/Other,Capability Building Other,0,0,0,0,0,0,0
LAB North,Jamaica,2024,CSD,Pepsi,STB - Push,Other Investments,CDA's,50,267287,132763,134524,1718,853,865
LAB North,Jamaica,2024,CSD,Pepsi,STB - Push,Other Investments,Capital (Coolers),0,0,0,0,0,0,0
LAB North,Jamaica,2024,CSD,Pepsi,STB - Push,Other Investments,Price Support,50,2365500,1173677,1191823,15212,7548,7664
LAB North,Jamaica,2024,CSD,Pepsi,STB - Push,Other Investments,Vending / Racks,0,0,0,0,0,0,0
LAB North,Jamaica,2024,CSD,Pepsi,STB - Push,Other Trade,Frozen Funds,0,0,0,0,0,0,0
LAB North,Jamaica,2024,CSD,Pepsi,STB - Push,Other Trade,Other Trade,50,105288,53373,51915,677,343,334
LAB North,Jamaica,2024,CSD,Pepsi,STB - Push,Trade Equipment,Coolers - New,0,0,0,0,0,0,0
LAB North,Jamaica,2024,CSD,Pepsi,STB - Push,Trade Equipment,Coolers - Refurbished,0,0,0,0,0,0,0
LAB North,Jamaica,2024,CSD,Pepsi,STB - Push,Trade Equipment,Post Mix / Pre Mix Equip.,0,0,0,0,0,0,0
LAB North,Jamaica,2024,CSD,Pepsi,STB - Push,Trade Equipment,Vending / Racks,0,0,0,0,0,0,0
LAB North,Jamaica,2024,CSD,Pepsi,STB - Push,Trade Programs,Distribution Incentives,50,266712,138210,128502,1715,888,827
LAB North,Jamaica,2024,CSD,Pepsi,STB - Push,Trade Programs,Innovation Investments,0,0,0,0,0,0,0
LAB North,Jamaica,2024,CSD,Pepsi,STB - Push,Trade Programs,Sales Incentives,50,9670,4701,4969,62,30,32
LAB North,Jamaica,2024,CSD,Pepsi,STB - Push,Trade Programs,Space Investments,50,97744,50653,47091,628,325,303
LAB North,Jamaica,2024,CSD,Pepsi,Pull-Working,All Other Working,Other Working - PR execution,50,57966,29190,28776,372,187,185
LAB North,Jamaica,2024,CSD,Pepsi,Pull-Working,All Other Working,Other Working - activation,50,230734,111165,119569,1483,714,769
LAB North,Jamaica,2024,CSD,Pepsi,Pull-Working,All Other Working,Other Working - non allocated working,0,0,0,0,0,0,0
LAB North,Jamaica,2024,CSD,Pepsi,Pull-Working,Consumer Promotions,Consumer Promotions Execution,0,0,0,0,0,0,0
LAB North,Jamaica,2024,CSD,Pepsi,Pull-Working,Consumer Promotions,Coupons,0,0,0,0,0,0,0
LAB North,Jamaica,2024,CSD,Pepsi,Pull-Working,Consumer Promotions,Other,0,0,0,0,0,0,0
LAB North,Jamaica,2024,CSD,Pepsi,Pull-Working,Consumer Promotions,Premiums,50,43918,22240,21678,282,143,139
LAB North,Jamaica,2024,CSD,Pepsi,Pull-Working,In Store & POS Execution,In-Store & POS Execution,50,204757,99528,105229,1316,640,676
LAB North,Jamaica,2024,CSD,Pepsi,Pull-Working,Media Placements,Cinema,0,0,0,0,0,0,0
LAB North,Jamaica,2024,CSD,Pepsi,Pull-Working,Media Placements,Digital,50,307461,147243,160218,1977,946,1031
LAB North,Jamaica,2024,CSD,Pepsi,Pull-Working,Media Placements,OOH - Out Of Home,50,199899,96330,103569,1285,619,666
LAB North,Jamaica,2024,CSD,Pepsi,Pull-Working,Media Placements,Other,50,15291,7500,7791,98,48,50
LAB North,Jamaica,2024,CSD,Pepsi,Pull-Working,Media Placements,Print,0,0,0,0,0,0,0
LAB North,Jamaica,2024,CSD,Pepsi,Pull-Working,Media Placements,Radio,50,149959,76470,73489,964,491,473
LAB North,Jamaica,2024,CSD,Pepsi,Pull-Working,Media Placements,TV,50,242230,122210,120020,1557,785,772
LAB North,Jamaica,2024,CSD,Pepsi,Pull-Working,Sampling,Product Samples,50,58888,29404,29484,378,189,189
LAB North,Jamaica,2024,CSD,Pepsi,Pull-Working,Sampling,Sampling Execution,50,58243,29387,28856,374,188,186
LAB North,Jamaica,2024,CSD,Pepsi,Pull-Working,Sponsorships,Sponsorships-in game/ in show,50,89021,44898,44123,572,288,284
LAB North,Jamaica,2024,CSD,Pepsi,Pull-Working,Sponsorships,Sports-athlete/team contracts,50,58871,30713,28158,378,197,181
LAB North,Jamaica,2024,CSD,Pepsi,Pull-Working,Sponsorships,Sports-on field or in show props,0,0,0,0,0,0,0
LAB North,Jamaica,2024,CSD,Pepsi,Pull-Working,Sponsorships,Sports-stadium contracts,0,0,0,0,0,0,0
LAB North,Jamaica,2024,Juices,Tropicana,Pull-Non-Working,Ad Production,Digital Ad Production,50,15002,7602,7400,96,48,48
LAB North,Jamaica,2024,Juices,Tropicana,Pull-Non-Working,Ad Production,"TV, Print, Radio, OOH, Production",0,0,0,0,0,0,0
LAB North,Jamaica,2024,Juices,Tropicana,Pull-Non-Working,Agency Fees,Creative Agency Fees,0,0,0,0,0,0,0
LAB North,Jamaica,2024,Juices,Tropicana,Pull-Non-Working,Agency Fees,In Store & POS Design / Development,0,0,0,0,0,0,0
LAB North,Jamaica,2024,Juices,Tropicana,Pull-Non-Working,Agency Fees,Media Agency Fees,0,0,0,0,0,0,0
LAB North,Jamaica,2024,Juices,Tropicana,Pull-Non-Working,Agency Fees,Other,0,0,0,0,0,0,0
LAB North,Jamaica,2024,Juices,Tropicana,Pull-Non-Working,Agency Fees,Social Media / Influence Marketing,50,42931,22182,20749,276,142,134
LAB North,Jamaica,2024,Juices,Tropicana,Pull-Non-Working,All Other Non-Working,Administrative fees,0,0,0,0,0,0,0
LAB North,Jamaica,2024,Juices,Tropicana,Pull-Non-Working,All Other Non-Working,Agency out of pocket,0,0,0,0,0,0,0
LAB North,Jamaica,2024,Juices,Tropicana,Pull-Non-Working,All Other Non-Working,CP out of pocket admin,0,0,0,0,0,0,0
LAB North,Jamaica,2024,Juices,Tropicana,Pull-Non-Working,All Other Non-Working,Grassroots/experiential out of pocket,0,0,0,0,0,0,0
LAB North,Jamaica,2024,Juices,Tropicana,Pull-Non-Working,All Other Non-Working,League/property- rights fee/options,0,0,0,0,0,0,0
LAB North,Jamaica,2024,Juices,Tropicana,Pull-Non-Working,All Other Non-Working,Market Research,0,0,0,0,0,0,0
LAB North,Jamaica,2024,Juices,Tropicana,Pull-Non-Working,All Other Non-Working,Non-allocated NW,0,0,0,0,0,0,0
LAB North,Jamaica,2024,Juices,Tropicana,Pull-Non-Working,All Other Non-Working,Other Non Working-non itemised talent,0,0,0,0,0,0,0
LAB North,Jamaica,2024,Juices,Tropicana,Pull-Non-Working,All Other Non-Working,PR out of pocket administrative,0,0,0,0,0,0,0
LAB North,Jamaica,2024,Juices,Tropicana,Pull-Non-Working,Innovation and Insight,Innovations,0,0,0,0,0,0,0
LAB North,Jamaica,2024,Juices,Tropicana,Pull-Non-Working,Innovation and Insight,Market Research,50,11991,5934,6057,77,38,39
LAB North,Jamaica,2024,Juices,Tropicana,Pull-Non-Working,Package Design,Package design,0,0,0,0,0,0,0
LAB North,Jamaica,2024,Juices,Tropicana,Pull-Non-Working,Package Design,Package development,0,0,0,0,0,0,0
LAB North,Jamaica,2024,Juices,Tropicana,STB - Push,Capability Building/Other,Capability Building Other,0,0,0,0,0,0,0
LAB North,Jamaica,2024,Juices,Tropicana,STB - Push,Other Investments,CDA's,0,0,0,0,0,0,0
LAB North,Jamaica,2024,Juices,Tropicana,STB - Push,Other Investments,Capital (Coolers),0,0,0,0,0,0,0
LAB North,Jamaica,2024,Juices,Tropicana,STB - Push,Other Investments,Price Support,50,648436,314909,333527,4170,2025,2145
LAB North,Jamaica,2024,Juices,Tropicana,STB - Push,Other Investments,Vending / Racks,0,0,0,0,0,0,0
LAB North,Jamaica,2024,Juices,Tropicana,STB - Push,Other Trade,Frozen Funds,0,0,0,0,0,0,0
LAB North,Jamaica,2024,Juices,Tropicana,STB - Push,Other Trade,Other Trade,0,0,0,0,0,0,0
LAB North,Jamaica,2024,Juices,Tropicana,STB - Push,Trade Equipment,Coolers - New,0,0,0,0,0,0,0
LAB North,Jamaica,2024,Juices,Tropicana,STB - Push,Trade Equipment,Coolers - Refurbished,0,0,0,0,0,0,0
LAB North,Jamaica,2024,Juices,Tropicana,STB - Push,Trade Equipment,Post Mix / Pre Mix Equip.,0,0,0,0,0,0,0
LAB North,Jamaica,2024,Juices,Tropicana,STB - Push,Trade Equipment,Vending / Racks,0,0,0,0,0,0,0
LAB North,Jamaica,2024,Juices,Tropicana,STB - Push,Trade Programs,Distribution Incentives,0,0,0,0,0,0,0
LAB North,Jamaica,2024,Juices,Tropicana,STB - Push,Trade Programs,Innovation Investments,0,0,0,0,0,0,0
LAB North,Jamaica,2024,Juices,Tropicana,STB - Push,Trade Programs,Sales Incentives,0,0,0,0,0,0,0
LAB North,Jamaica,2024,Juices,Tropicana,STB - Push,Trade Programs,Space Investments,50,24013,12328,11685,154,79,75
LAB North,Jamaica,2024,Juices,Tropicana,Pull-Working,All Other Working,Other Working - PR execution,0,0,0,0,0,0,0
LAB North,Jamaica,2024,Juices,Tropicana,Pull-Working,All Other Working,Other Working - activation,0,0,0,0,0,0,0
LAB North,Jamaica,2024,Juices,Tropicana,Pull-Working,All Other Working,Other Working - non allocated working,0,0,0,0,0,0,0
LAB North,Jamaica,2024,Juices,Tropicana,Pull-Working,Consumer Promotions,Consumer Promotions Execution,0,0,0,0,0,0,0
LAB North,Jamaica,2024,Juices,Tropicana,Pull-Working,Consumer Promotions,Coupons,0,0,0,0,0,0,0
LAB North,Jamaica,2024,Juices,Tropicana,Pull-Working,Consumer Promotions,Other,0,0,0,0,0,0,0
LAB North,Jamaica,2024,Juices,Tropicana,Pull-Working,Consumer Promotions,Premiums,50,10478,5229,5249,67,33,34
LAB North,Jamaica,2024,Juices,Tropicana,Pull-Working,In Store & POS Execution,In-Store & POS Execution,50,17208,8691,8517,110,55,55
LAB North,Jamaica,2024,Juices,Tropicana,Pull-Working,Media Placements,Cinema,0,0,0,0,0,0,0
LAB North,Jamaica,2024,Juices,Tropicana,Pull-Working,Media Placements,Digital,50,17081,8863,8218,109,56,53
LAB North,Jamaica,2024,Juices,Tropicana,Pull-Working,Media Placements,OOH - Out Of Home,0,0,0,0,0,0,0
LAB North,Jamaica,2024,Juices,Tropicana,Pull-Working,Media Placements,Other,0,0,0,0,0,0,0
LAB North,Jamaica,2024,Juices,Tropicana,Pull-Working,Media Placements,Print,0,0,0,0,0,0,0
LAB North,Jamaica,2024,Juices,Tropicana,Pull-Working,Media Placements,Radio,50,6510,3264,3246,41,20,21
LAB North,Jamaica,2024,Juices,Tropicana,Pull-Working,Media Placements,TV,0,0,0,0,0,0,0
LAB North,Jamaica,2024,Juices,Tropicana,Pull-Working,Sampling,Product Samples,0,0,0,0,0,0,0
LAB North,Jamaica,2024,Juices,Tropicana,Pull-Working,Sampling,Sampling Execution,0,0,0,0,0,0,0
LAB North,Jamaica,2024,Juices,Tropicana,Pull-Working,Sponsorships,Sponsorships-in game/ in show,50,3473,1715,1758,22,11,11
LAB North,Jamaica,2024,Juices,Tropicana,Pull-Working,Sponsorships,Sports-athlete/team contracts,0,0,0,0,0,0,0
LAB North,Jamaica,2024,Juices,Tropicana,Pull-Working,Sponsorships,Sports-on field or in show props,0,0,0,0,0,0,0
LAB North,Jamaica,2024,Juices,Tropicana,Pull-Working,Sponsorships,Sports-stadium contracts,0,0,0,0,0,0,0
LAB Mexico,Mexico,2024,Water,Be-Light,Pull-Non-Working,Ad Production,Digital Ad Production,0,0,0,0,0,0,0
LAB Mexico,Mexico,2024,Water,Be-Light,Pull-Non-Working,Ad Production,Other Ad Production,0,0,0,0,0,0,0
LAB Mexico,Mexico,2024,Water,Be-Light,Pull-Non-Working,Ad Production,TV Print Radio OOH Prod,100,353669,351133,2536,19761,19619,142
LAB Mexico,Mexico,2024,Water,Be-Light,Pull-Non-Working,Agency Fees,Creative Agency Fees,0,0,0,0,0,0,0
LAB Mexico,Mexico,2024,Water,Be-Light,Pull-Non-Working,Agency Fees,In Store and POS Design/Development,0,0,0,0,0,0,0
LAB Mexico,Mexico,2024,Water,Be-Light,Pull-Non-Working,Agency Fees,Media Agency Fees,100,6261093,6069405,191688,349841,339130,10711
LAB Mexico,Mexico,2024,Water,Be-Light,Pull-Non-Working,Agency Fees,Other Agency Fees,0,0,0,0,0,0,0
LAB Mexico,Mexico,2024,Water,Be-Light,Pull-Non-Working,Agency Fees,Social Media/Influence Marketing,0,0,0,0,0,0,0
LAB Mexico,Mexico,2024,Water,Be-Light,Pull-Non-Working,Innovation and Insight,Innovation,0,0,0,0,0,0,0
LAB Mexico,Mexico,2024,Water,Be-Light,Pull-Non-Working,Innovation and Insight,Market Research,0,0,0,0,0,0,0
LAB Mexico,Mexico,2024,Water,Be-Light,Pull-Non-Working,Innovation and Insight,Other Innovation and Insight,0,0,0,0,0,0,0
LAB Mexico,Mexico,2024,Water,Be-Light,Pull-Non-Working,Insight,Advanced Analytics,100,723702,714256,9446,40437,39909,528
LAB Mexico,Mexico,2024,Water,Be-Light,Pull-Non-Working,Insight,Brand Building,0,0,0,0,0,0,0
LAB Mexico,Mexico,2024,Water,Be-Light,Pull-Non-Working,Insight,Consumer Tracking,100,5022708,5022708,0,280645,280645,0
LAB Mexico,Mexico,2024,Water,Be-Light,Pull-Non-Working,Insight,Customer / Retail and Insights and Analytics,100,551211,518675,32536,30799,28981,1818
LAB Mexico,Mexico,2024,Water,Be-Light,Pull-Non-Working,Insight,Foundational Data / Systems,0,0,0,0,0,0,0
LAB Mexico,Mexico,2024,Water,Be-Light,Pull-Non-Working,Insight,Innovation Insights,0,0,0,0,0,0,0
LAB Mexico,Mexico,2024,Water,Be-Light,Pull-Non-Working,Insight,Strategic Insights,100,3636640,3590989,45651,203198,200647,2551
LAB Mexico,Mexico,2024,Water,Be-Light,Pull-Non-Working,Other Non Working,All Other Non Working,100,4521228,4319928,201300,252625,241377,11248
LAB Mexico,Mexico,2024,Water,Be-Light,Pull-Non-Working,Other Non Working,NW-Cross Charges,0,0,0,0,0,0,0
LAB Mexico,Mexico,2024,Water,Be-Light,Pull-Non-Working,Other Non Working,NW-Excluded non-A&M Items,0,0,0,0,0,0,0
LAB Mexico,Mexico,2024,Water,Be-Light,Pull-Non-Working,Other Non Working,NW-Fall In / Fall Out,0,0,0,0,0,0,0
LAB Mexico,Mexico,2024,Water,Be-Light,Pull-Non-Working,Other Non Working,Out of Scope Countries ( D8 Gastos),0,0,0,0,0,0,0
LAB Mexico,Mexico,2024,Water,Be-Light,Pull-Non-Working,Package Design,Other Package Design,0,0,0,0,0,0,0
LAB Mexico,Mexico,2024,Water,Be-Light,Pull-Non-Working,Package Design,Package Design,0,0,0,0,0,0,0
LAB Mexico,Mexico,2024,Water,Be-Light,Pull-Working,Consumer Promotions,Consumer Promotions Execution,0,55739485,0,55739485,3114466,0,3114466
LAB Mexico,Mexico,2024,Water,Be-Light,Pull-Working,Consumer Promotions,Coupons (Redemption),0,0,0,0,0,0,0
LAB Mexico,Mexico,2024,Water,Be-Light,Pull-Working,Consumer Promotions,Other Consumer Promotions,0,0,0,0,0,0,0
LAB Mexico,Mexico,2024,Water,Be-Light,Pull-Working,Consumer Promotions,Premiums,0,0,0,0,0,0,0
LAB Mexico,Mexico,2024,Water,Be-Light,Pull-Working,In Store & POS Execution,In-Store and POS Execution,100,2759189,2610360,148829,154170,145854,8316
LAB Mexico,Mexico,2024,Water,Be-Light,Pull-Working,In Store & POS Execution,Other In-Store and POS Execution,0,0,0,0,0,0,0
LAB Mexico,Mexico,2024,Water,Be-Light,Pull-Working,Media Placements,Digital Media,0,0,0,0,0,0,0
LAB Mexico,Mexico,2024,Water,Be-Light,Pull-Working,Media Placements,Media Placements,100,20968362,20968362,0,1171615,1171615,0
LAB Mexico,Mexico,2024,Water,Be-Light,Pull-Working,Media Placements,Other Media,0,0,0,0,0,0,0
LAB Mexico,Mexico,2024,Water,Be-Light,Pull-Working,Other Working,All Other Working,100,910212,864475,45737,50858,48302,2556
LAB Mexico,Mexico,2024,Water,Be-Light,Pull-Working,Other Working,W-Cross Charges,0,0,0,0,0,0,0
LAB Mexico,Mexico,2024,Water,Be-Light,Pull-Working,Other Working,W-Excluded non-A&M Items,0,0,0,0,0,0,0
LAB Mexico,Mexico,2024,Water,Be-Light,Pull-Working,Other Working,W-Fall In / Fall Out,0,0,0,0,0,0,0
LAB Mexico,Mexico,2024,Water,Be-Light,Pull-Working,Sampling,Other Sampling,0,0,0,0,0,0,0
LAB Mexico,Mexico,2024,Water,Be-Light,Pull-Working,Sampling,Product Samples,0,0,0,0,0,0,0
LAB Mexico,Mexico,2024,Water,Be-Light,Pull-Working,Sampling,Sample Executing,100,1232043,1232043,0,68840,68840,0
LAB Mexico,Mexico,2024,Water,Be-Light,Pull-Working,Sponsorships,Other Sponsorships,0,0,0,0,0,0,0
LAB Mexico,Mexico,2024,Water,Be-Light,Pull-Working,Sponsorships,Sponsorships,0,0,0,0,0,0,0
LAB Mexico,Mexico,2024,Water,Be-Light,STB - Push,Capability Building/Other,Capability Building,0,0,0,0,0,0,0
LAB Mexico,Mexico,2024,Water,Be-Light,STB - Push,Capability Building/Other,Capability Building/Other-Other,0,0,0,0,0,0,0
LAB Mexico,Mexico,2024,Water,Be-Light,STB - Push,Trade Equipment,On Premise Equipment,0,0,0,0,0,0,0
LAB Mexico,Mexico,2024,Water,Be-Light,STB - Push,Trade Equipment,"Stands/ Racks, Other Trade Equipment",0,181884,0,181884,10162,0,10162
LAB Mexico,Mexico,2024,Water,Be-Light,STB - Push,Trade Equipment,Trade Equipment-Other,0,0,0,0,0,0,0
LAB Mexico,Mexico,2024,Water,Be-Light,STB - Push,Trade Programs,Distribution Incentives,0,4735129,0,4735129,264577,0,264577
LAB Mexico,Mexico,2024,Water,Be-Light,STB - Push,Trade Programs,Innovation Investments,0,0,0,0,0,0,0
LAB Mexico,Mexico,2024,Water,Be-Light,STB - Push,Trade Programs,Other Trade Programs,0,0,0,0,0,0,0
LAB Mexico,Mexico,2024,Water,Be-Light,STB - Push,Trade Programs,Sales Incentives,0,0,0,0,0,0,0
LAB Mexico,Mexico,2024,Water,Be-Light,STB - Push,Trade Programs,Space Investments,0,13906718,0,13906718,777043,0,777043
LAB Mexico,Mexico,2024,Water,Be-Light,STB - Push,Unilateral,CDAs,0,55612061,0,55612061,3107346,0,3107346
LAB Mexico,Mexico,2024,Water,Be-Light,STB - Push,Unilateral,Capital Equipment,0,0,0,0,0,0,0
LAB Mexico,Mexico,2024,Water,Be-Light,STB - Push,Unilateral,Other Unilateral,0,0,0,0,0,0,0
LAB Mexico,Mexico,2024,Water,Be-Light,STB - Push,Unilateral,Price Support,0,0,0,0,0,0,0
LAB Mexico,Mexico,2024,Sport Drinks,Gatorade,Pull-Non-Working,Ad Production,Digital Ad Production,0,0,0,0,0,0,0
LAB Mexico,Mexico,2024,Sport Drinks,Gatorade,Pull-Non-Working,Ad Production,Other Ad Production,0,0,0,0,0,0,0
LAB Mexico,Mexico,2024,Sport Drinks,Gatorade,Pull-Non-Working,Ad Production,TV Print Radio OOH Prod,100,6251933,6207233,44700,349329,346831,2498
LAB Mexico,Mexico,2024,Sport Drinks,Gatorade,Pull-Non-Working,Agency Fees,Creative Agency Fees,0,0,0,0,0,0,0
LAB Mexico,Mexico,2024,Sport Drinks,Gatorade,Pull-Non-Working,Agency Fees,In Store and POS Design/Development,0,0,0,0,0,0,0
LAB Mexico,Mexico,2024,Sport Drinks,Gatorade,Pull-Non-Working,Agency Fees,Media Agency Fees,100,6159907,6159907,0,344187,344187,0
LAB Mexico,Mexico,2024,Sport Drinks,Gatorade,Pull-Non-Working,Agency Fees,Other Agency Fees,0,0,0,0,0,0,0
LAB Mexico,Mexico,2024,Sport Drinks,Gatorade,Pull-Non-Working,Agency Fees,Social Media/Influence Marketing,0,0,0,0,0,0,0
LAB Mexico,Mexico,2024,Sport Drinks,Gatorade,Pull-Non-Working,Innovation and Insight,Innovation,0,0,0,0,0,0,0
LAB Mexico,Mexico,2024,Sport Drinks,Gatorade,Pull-Non-Working,Innovation and Insight,Market Research,0,0,0,0,0,0,0
LAB Mexico,Mexico,2024,Sport Drinks,Gatorade,Pull-Non-Working,Innovation and Insight,Other Innovation and Insight,0,0,0,0,0,0,0
LAB Mexico,Mexico,2024,Sport Drinks,Gatorade,Pull-Non-Working,Insight,Advanced Analytics,100,3475055,3475055,0,194170,194170,0
LAB Mexico,Mexico,2024,Sport Drinks,Gatorade,Pull-Non-Working,Insight,Brand Building,0,0,0,0,0,0,0
LAB Mexico,Mexico,2024,Sport Drinks,Gatorade,Pull-Non-Working,Insight,Consumer Tracking,100,5365842,5365842,0,299818,299818,0
LAB Mexico,Mexico,2024,Sport Drinks,Gatorade,Pull-Non-Working,Insight,Customer / Retail and Insights and Analytics,100,672629,672629,0,37583,37583,0
LAB Mexico,Mexico,2024,Sport Drinks,Gatorade,Pull-Non-Working,Insight,Foundational Data / Systems,0,0,0,0,0,0,0
LAB Mexico,Mexico,2024,Sport Drinks,Gatorade,Pull-Non-Working,Insight,Innovation Insights,0,0,0,0,0,0,0
LAB Mexico,Mexico,2024,Sport Drinks,Gatorade,Pull-Non-Working,Insight,Strategic Insights,100,4731168,4669047,62121,264355,260884,3471
LAB Mexico,Mexico,2024,Sport Drinks,Gatorade,Pull-Non-Working,Other Non Working,All Other Non Working,100,13942645,13704326,238319,779050,765734,13316
LAB Mexico,Mexico,2024,Sport Drinks,Gatorade,Pull-Non-Working,Other Non Working,NW-Cross Charges,0,0,0,0,0,0,0
LAB Mexico,Mexico,2024,Sport Drinks,Gatorade,Pull-Non-Working,Other Non Working,NW-Excluded non-A&M Items,0,0,0,0,0,0,0
LAB Mexico,Mexico,2024,Sport Drinks,Gatorade,Pull-Non-Working,Other Non Working,NW-Fall In / Fall Out,0,0,0,0,0,0,0
LAB Mexico,Mexico,2024,Sport Drinks,Gatorade,Pull-Non-Working,Other Non Working,Out of Scope Countries ( D8 Gastos),0,0,0,0,0,0,0
LAB Mexico,Mexico,2024,Sport Drinks,Gatorade,Pull-Non-Working,Package Design,Other Package Design,0,0,0,0,0,0,0
LAB Mexico,Mexico,2024,Sport Drinks,Gatorade,Pull-Non-Working,Package Design,Package Design,0,0,0,0,0,0,0
LAB Mexico,Mexico,2024,Sport Drinks,Gatorade,Pull-Working,Consumer Promotions,Consumer Promotions Execution,0,136623431,0,136623431,7633889,0,7633889
LAB Mexico,Mexico,2024,Sport Drinks,Gatorade,Pull-Working,Consumer Promotions,Coupons (Redemption),0,0,0,0,0,0,0
LAB Mexico,Mexico,2024,Sport Drinks,Gatorade,Pull-Working,Consumer Promotions,Other Consumer Promotions,0,0,0,0,0,0,0
LAB Mexico,Mexico,2024,Sport Drinks,Gatorade,Pull-Working,Consumer Promotions,Premiums,100,7475657,7380638,95019,417705,412396,5309
LAB Mexico,Mexico,2024,Sport Drinks,Gatorade,Pull-Working,In Store & POS Execution,In-Store and POS Execution,100,11994861,11538051,456810,670217,644693,25524
LAB Mexico,Mexico,2024,Sport Drinks,Gatorade,Pull-Working,In Store & POS Execution,Other In-Store and POS Execution,0,0,0,0,0,0,0
LAB Mexico,Mexico,2024,Sport Drinks,Gatorade,Pull-Working,Media Placements,Digital Media,0,0,0,0,0,0,0
LAB Mexico,Mexico,2024,Sport Drinks,Gatorade,Pull-Working,Media Placements,Media Placements,100,53598824,52303779,1295045,2994856,2922494,72362
LAB Mexico,Mexico,2024,Sport Drinks,Gatorade,Pull-Working,Media Placements,Other Media,0,0,0,0,0,0,0
LAB Mexico,Mexico,2024,Sport Drinks,Gatorade,Pull-Working,Other Working,All Other Working,100,16655366,16655366,0,930625,930625,0
LAB Mexico,Mexico,2024,Sport Drinks,Gatorade,Pull-Working,Other Working,W-Cross Charges,0,0,0,0,0,0,0
LAB Mexico,Mexico,2024,Sport Drinks,Gatorade,Pull-Working,Other Working,W-Excluded non-A&M Items,0,0,0,0,0,0,0
LAB Mexico,Mexico,2024,Sport Drinks,Gatorade,Pull-Working,Other Working,W-Fall In / Fall Out,0,0,0,0,0,0,0
LAB Mexico,Mexico,2024,Sport Drinks,Gatorade,Pull-Working,Sampling,Other Sampling,0,0,0,0,0,0,0
LAB Mexico,Mexico,2024,Sport Drinks,Gatorade,Pull-Working,Sampling,Product Samples,0,0,0,0,0,0,0
LAB Mexico,Mexico,2024,Sport Drinks,Gatorade,Pull-Working,Sampling,Sample Executing,100,1363230,1363230,0,76171,76171,0
LAB Mexico,Mexico,2024,Sport Drinks,Gatorade,Pull-Working,Sponsorships,Other Sponsorships,0,0,0,0,0,0,0
LAB Mexico,Mexico,2024,Sport Drinks,Gatorade,Pull-Working,Sponsorships,Sponsorships,100,63584590,63584590,0,3552814,3552814,0
LAB Mexico,Mexico,2024,Sport Drinks,Gatorade,STB - Push,Capability Building/Other,Capability Building,0,1400822,0,1400822,78271,0,78271
LAB Mexico,Mexico,2024,Sport Drinks,Gatorade,STB - Push,Capability Building/Other,Capability Building/Other-Other,0,0,0,0,0,0,0
LAB Mexico,Mexico,2024,Sport Drinks,Gatorade,STB - Push,Trade Equipment,On Premise Equipment,0,682249,0,682249,38120,0,38120
LAB Mexico,Mexico,2024,Sport Drinks,Gatorade,STB - Push,Trade Equipment,"Stands/ Racks, Other Trade Equipment",0,1423656,0,1423656,79547,0,79547
LAB Mexico,Mexico,2024,Sport Drinks,Gatorade,STB - Push,Trade Equipment,Trade Equipment-Other,0,0,0,0,0,0,0
LAB Mexico,Mexico,2024,Sport Drinks,Gatorade,STB - Push,Trade Programs,Distribution Incentives,0,64275500,0,64275500,3591419,0,3591419
LAB Mexico,Mexico,2024,Sport Drinks,Gatorade,STB - Push,Trade Programs,Innovation Investments,0,0,0,0,0,0,0
LAB Mexico,Mexico,2024,Sport Drinks,Gatorade,STB - Push,Trade Programs,Other Trade Programs,0,0,0,0,0,0,0
LAB Mexico,Mexico,2024,Sport Drinks,Gatorade,STB - Push,Trade Programs,Sales Incentives,0,0,0,0,0,0,0
LAB Mexico,Mexico,2024,Sport Drinks,Gatorade,STB - Push,Trade Programs,Space Investments,0,65744743,0,65744743,3673514,0,3673514
LAB Mexico,Mexico,2024,Sport Drinks,Gatorade,STB - Push,Unilateral,CDAs,0,223804494,0,223804494,12505167,0,12505167
LAB Mexico,Mexico,2024,Sport Drinks,Gatorade,STB - Push,Unilateral,Capital Equipment,0,0,0,0,0,0,0
LAB Mexico,Mexico,2024,Sport Drinks,Gatorade,STB - Push,Unilateral,Other Unilateral,0,0,0,0,0,0,0
LAB Mexico,Mexico,2024,Sport Drinks,Gatorade,STB - Push,Unilateral,Price Support,0,0,0,0,0,0,0
LAB Mexico,Mexico,2024,RTD Tea,Lipton,Pull-Non-Working,Ad Production,Digital Ad Production,0,0,0,0,0,0,0
LAB Mexico,Mexico,2024,RTD Tea,Lipton,Pull-Non-Working,Ad Production,Other Ad Production,0,0,0,0,0,0,0
LAB Mexico,Mexico,2024,RTD Tea,Lipton,Pull-Non-Working,Ad Production,TV Print Radio OOH Prod,100,465731,465731,0,26022,26022,0
LAB Mexico,Mexico,2024,RTD Tea,Lipton,Pull-Non-Working,Agency Fees,Creative Agency Fees,0,0,0,0,0,0,0
LAB Mexico,Mexico,2024,RTD Tea,Lipton,Pull-Non-Working,Agency Fees,In Store and POS Design/Development,0,0,0,0,0,0,0
LAB Mexico,Mexico,2024,RTD Tea,Lipton,Pull-Non-Working,Agency Fees,Media Agency Fees,100,745864,745200,664,41675,41638,37
LAB Mexico,Mexico,2024,RTD Tea,Lipton,Pull-Non-Working,Agency Fees,Other Agency Fees,0,0,0,0,0,0,0
LAB Mexico,Mexico,2024,RTD Tea,Lipton,Pull-Non-Working,Agency Fees,Social Media/Influence Marketing,0,0,0,0,0,0,0
LAB Mexico,Mexico,2024,RTD Tea,Lipton,Pull-Non-Working,Innovation and Insight,Innovation,0,0,0,0,0,0,0
LAB Mexico,Mexico,2024,RTD Tea,Lipton,Pull-Non-Working,Innovation and Insight,Market Research,0,0,0,0,0,0,0
LAB Mexico,Mexico,2024,RTD Tea,Lipton,Pull-Non-Working,Innovation and Insight,Other Innovation and Insight,0,0,0,0,0,0,0
LAB Mexico,Mexico,2024,RTD Tea,Lipton,Pull-Non-Working,Insight,Advanced Analytics,100,814671,793547,21124,45520,44339,1181
LAB Mexico,Mexico,2024,RTD Tea,Lipton,Pull-Non-Working,Insight,Brand Building,0,0,0,0,0,0,0
LAB Mexico,Mexico,2024,RTD Tea,Lipton,Pull-Non-Working,Insight,Consumer Tracking,100,1154949,1147731,7218,64533,64129,404
LAB Mexico,Mexico,2024,RTD Tea,Lipton,Pull-Non-Working,Insight,Customer / Retail and Insights and Analytics,0,0,0,0,0,0,0
LAB Mexico,Mexico,2024,RTD Tea,Lipton,Pull-Non-Working,Insight,Foundational Data / Systems,0,0,0,0,0,0,0
LAB Mexico,Mexico,2024,RTD Tea,Lipton,Pull-Non-Working,Insight,Innovation Insights,0,0,0,0,0,0,0
LAB Mexico,Mexico,2024,RTD Tea,Lipton,Pull-Non-Working,Insight,Strategic Insights,100,209876,209876,0,11726,11726,0
LAB Mexico,Mexico,2024,RTD Tea,Lipton,Pull-Non-Working,Other Non Working,All Other Non Working,100,1620575,1620575,0,90550,90550,0
LAB Mexico,Mexico,2024,RTD Tea,Lipton,Pull-Non-Working,Other Non Working,NW-Cross Charges,0,0,0,0,0,0,0
LAB Mexico,Mexico,2024,RTD Tea,Lipton,Pull-Non-Working,Other Non Working,NW-Excluded non-A&M Items,0,0,0,0,0,0,0
LAB Mexico,Mexico,2024,RTD Tea,Lipton,Pull-Non-Working,Other Non Working,NW-Fall In / Fall Out,0,0,0,0,0,0,0
LAB Mexico,Mexico,2024,RTD Tea,Lipton,Pull-Non-Working,Other Non Working,Out of Scope Countries ( D8 Gastos),0,0,0,0,0,0,0
LAB Mexico,Mexico,2024,RTD Tea,Lipton,Pull-Non-Working,Package Design,Other Package Design,0,0,0,0,0,0,0
LAB Mexico,Mexico,2024,RTD Tea,Lipton,Pull-Non-Working,Package Design,Package Design,0,0,0,0,0,0,0
LAB Mexico,Mexico,2024,RTD Tea,Lipton,Pull-Working,Consumer Promotions,Consumer Promotions Execution,0,5056502,0,5056502,282534,0,282534
LAB Mexico,Mexico,2024,RTD Tea,Lipton,Pull-Working,Consumer Promotions,Coupons (Redemption),0,0,0,0,0,0,0
LAB Mexico,Mexico,2024,RTD Tea,Lipton,Pull-Working,Consumer Promotions,Other Consumer Promotions,0,0,0,0,0,0,0
LAB Mexico,Mexico,2024,RTD Tea,Lipton,Pull-Working,Consumer Promotions,Premiums,0,0,0,0,0,0,0
LAB Mexico,Mexico,2024,RTD Tea,Lipton,Pull-Working,In Store & POS Execution,In-Store and POS Execution,0,0,0,0,0,0,0
LAB Mexico,Mexico,2024,RTD Tea,Lipton,Pull-Working,In Store & POS Execution,Other In-Store and POS Execution,0,0,0,0,0,0,0
LAB Mexico,Mexico,2024,RTD Tea,Lipton,Pull-Working,Media Placements,Digital Media,0,0,0,0,0,0,0
LAB Mexico,Mexico,2024,RTD Tea,Lipton,Pull-Working,Media Placements,Media Placements,100,3262795,3225820,36975,182309,180244,2065
LAB Mexico,Mexico,2024,RTD Tea,Lipton,Pull-Working,Media Placements,Other Media,0,0,0,0,0,0,0
LAB Mexico,Mexico,2024,RTD Tea,Lipton,Pull-Working,Other Working,All Other Working,100,383710,361684,22026,21439,20209,1230
LAB Mexico,Mexico,2024,RTD Tea,Lipton,Pull-Working,Other Working,W-Cross Charges,0,0,0,0,0,0,0
LAB Mexico,Mexico,2024,RTD Tea,Lipton,Pull-Working,Other Working,W-Excluded non-A&M Items,0,0,0,0,0,0,0
LAB Mexico,Mexico,2024,RTD Tea,Lipton,Pull-Working,Other Working,W-Fall In / Fall Out,0,0,0,0,0,0,0
LAB Mexico,Mexico,2024,RTD Tea,Lipton,Pull-Working,Sampling,Other Sampling,0,0,0,0,0,0,0
LAB Mexico,Mexico,2024,RTD Tea,Lipton,Pull-Working,Sampling,Product Samples,0,0,0,0,0,0,0
LAB Mexico,Mexico,2024,RTD Tea,Lipton,Pull-Working,Sampling,Sample Executing,100,156084,156084,0,8721,8721,0
LAB Mexico,Mexico,2024,RTD Tea,Lipton,Pull-Working,Sponsorships,Other Sponsorships,0,0,0,0,0,0,0
LAB Mexico,Mexico,2024,RTD Tea,Lipton,Pull-Working,Sponsorships,Sponsorships,0,0,0,0,0,0,0
LAB Mexico,Mexico,2024,RTD Tea,Lipton,STB - Push,Capability Building/Other,Capability Building,0,0,0,0,0,0,0
LAB Mexico,Mexico,2024,RTD Tea,Lipton,STB - Push,Capability Building/Other,Capability Building/Other-Other,0,0,0,0,0,0,0
LAB Mexico,Mexico,2024,RTD Tea,Lipton,STB - Push,Trade Equipment,On Premise Equipment,0,52742,0,52742,2946,0,2946
LAB Mexico,Mexico,2024,RTD Tea,Lipton,STB - Push,Trade Equipment,"Stands/ Racks, Other Trade Equipment",0,53089,0,53089,2966,0,2966
LAB Mexico,Mexico,2024,RTD Tea,Lipton,STB - Push,Trade Equipment,Trade Equipment-Other,0,0,0,0,0,0,0
LAB Mexico,Mexico,2024,RTD Tea,Lipton,STB - Push,Trade Programs,Distribution Incentives,0,2800838,0,2800838,156497,0,156497
LAB Mexico,Mexico,2024,RTD Tea,Lipton,STB - Push,Trade Programs,Innovation Investments,0,0,0,0,0,0,0
LAB Mexico,Mexico,2024,RTD Tea,Lipton,STB - Push,Trade Programs,Other Trade Programs,0,0,0,0,0,0,0
LAB Mexico,Mexico,2024,RTD Tea,Lipton,STB - Push,Trade Programs,Sales Incentives,0,0,0,0,0,0,0
LAB Mexico,Mexico,2024,RTD Tea,Lipton,STB - Push,Trade Programs,Space Investments,0,9383226,0,9383226,524291,0,524291
LAB Mexico,Mexico,2024,RTD Tea,Lipton,STB - Push,Unilateral,CDAs,0,26812601,0,26812601,1498164,0,1498164
LAB Mexico,Mexico,2024,RTD Tea,Lipton,STB - Push,Unilateral,Capital Equipment,0,0,0,0,0,0,0
LAB Mexico,Mexico,2024,RTD Tea,Lipton,STB - Push,Unilateral,Other Unilateral,0,0,0,0,0,0,0
LAB Mexico,Mexico,2024,RTD Tea,Lipton,STB - Push,Unilateral,Price Support,0,0,0,0,0,0,0
LAB Mexico,Mexico,2024,CSD,Pepsi,Pull-Non-Working,Ad Production,Digital Ad Production,0,0,0,0,0,0,0
LAB Mexico,Mexico,2024,CSD,Pepsi,Pull-Non-Working,Ad Production,Other Ad Production,0,0,0,0,0,0,0
LAB Mexico,Mexico,2024,CSD,Pepsi,Pull-Non-Working,Ad Production,TV Print Radio OOH Prod,100,12174152,12174152,0,680235,680235,0
LAB Mexico,Mexico,2024,CSD,Pepsi,Pull-Non-Working,Agency Fees,Creative Agency Fees,0,0,0,0,0,0,0
LAB Mexico,Mexico,2024,CSD,Pepsi,Pull-Non-Working,Agency Fees,In Store and POS Design/Development,0,0,0,0,0,0,0
LAB Mexico,Mexico,2024,CSD,Pepsi,Pull-Non-Working,Agency Fees,Media Agency Fees,100,26748693,26340885,407808,1494594,1471807,22787
LAB Mexico,Mexico,2024,CSD,Pepsi,Pull-Non-Working,Agency Fees,Other Agency Fees,0,0,0,0,0,0,0
LAB Mexico,Mexico,2024,CSD,Pepsi,Pull-Non-Working,Agency Fees,Social Media/Influence Marketing,0,0,0,0,0,0,0
LAB Mexico,Mexico,2024,CSD,Pepsi,Pull-Non-Working,Innovation and Insight,Innovation,0,0,0,0,0,0,0
LAB Mexico,Mexico,2024,CSD,Pepsi,Pull-Non-Working,Innovation and Insight,Market Research,0,0,0,0,0,0,0
LAB Mexico,Mexico,2024,CSD,Pepsi,Pull-Non-Working,Innovation and Insight,Other Innovation and Insight,0,0,0,0,0,0,0
LAB Mexico,Mexico,2024,CSD,Pepsi,Pull-Non-Working,Insight,Advanced Analytics,100,43418938,42869858,549080,2426050,2395370,30680
LAB Mexico,Mexico,2024,CSD,Pepsi,Pull-Non-Working,Insight,Brand Building,0,0,0,0,0,0,0
LAB Mexico,Mexico,2024,CSD,Pepsi,Pull-Non-Working,Insight,Consumer Tracking,100,21137543,20565112,572431,1181068,1149083,31985
LAB Mexico,Mexico,2024,CSD,Pepsi,Pull-Non-Working,Insight,Customer / Retail and Insights and Analytics,100,549809,549809,0,30720,30720,0
LAB Mexico,Mexico,2024,CSD,Pepsi,Pull-Non-Working,Insight,Foundational Data / Systems,0,0,0,0,0,0,0
LAB Mexico,Mexico,2024,CSD,Pepsi,Pull-Non-Working,Insight,Innovation Insights,0,0,0,0,0,0,0
LAB Mexico,Mexico,2024,CSD,Pepsi,Pull-Non-Working,Insight,Strategic Insights,100,13995721,13806367,189354,782016,771436,10580
LAB Mexico,Mexico,2024,CSD,Pepsi,Pull-Non-Working,Other Non Working,All Other Non Working,100,67170108,67170108,0,3753157,3753157,0
LAB Mexico,Mexico,2024,CSD,Pepsi,Pull-Non-Working,Other Non Working,NW-Cross Charges,0,0,0,0,0,0,0
LAB Mexico,Mexico,2024,CSD,Pepsi,Pull-Non-Working,Other Non Working,NW-Excluded non-A&M Items,0,0,0,0,0,0,0
LAB Mexico,Mexico,2024,CSD,Pepsi,Pull-Non-Working,Other Non Working,NW-Fall In / Fall Out,0,0,0,0,0,0,0
LAB Mexico,Mexico,2024,CSD,Pepsi,Pull-Non-Working,Other Non Working,Out of Scope Countries ( D8 Gastos),0,0,0,0,0,0,0
LAB Mexico,Mexico,2024,CSD,Pepsi,Pull-Non-Working,Package Design,Other Package Design,0,0,0,0,0,0,0
LAB Mexico,Mexico,2024,CSD,Pepsi,Pull-Non-Working,Package Design,Package Design,0,0,0,0,0,0,0
LAB Mexico,Mexico,2024,CSD,Pepsi,Pull-Working,Consumer Promotions,Consumer Promotions Execution,0,1022008290,0,1022008290,57105128,0,57105128
LAB Mexico,Mexico,2024,CSD,Pepsi,Pull-Working,Consumer Promotions,Coupons (Redemption),0,0,0,0,0,0,0
LAB Mexico,Mexico,2024,CSD,Pepsi,Pull-Working,Consumer Promotions,Other Consumer Promotions,0,0,0,0,0,0,0
LAB Mexico,Mexico,2024,CSD,Pepsi,Pull-Working,Consumer Promotions,Premiums,100,45131031,45131031,0,2521714,2521714,0
LAB Mexico,Mexico,2024,CSD,Pepsi,Pull-Working,In Store & POS Execution,In-Store and POS Execution,100,81638574,81638574,0,4561588,4561588,0
LAB Mexico,Mexico,2024,CSD,Pepsi,Pull-Working,In Store & POS Execution,Other In-Store and POS Execution,0,0,0,0,0,0,0
LAB Mexico,Mexico,2024,CSD,Pepsi,Pull-Working,Media Placements,Digital Media,0,0,0,0,0,0,0
LAB Mexico,Mexico,2024,CSD,Pepsi,Pull-Working,Media Placements,Media Placements,100,224538321,218259804,6278517,12546169,12195355,350814
LAB Mexico,Mexico,2024,CSD,Pepsi,Pull-Working,Media Placements,Other Media,100,1401879,1357664,44215,78330,75860,2470
LAB Mexico,Mexico,2024,CSD,Pepsi,Pull-Working,Other Working,All Other Working,100,18964790,18964790,0,1059665,1059665,0
LAB Mexico,Mexico,2024,CSD,Pepsi,Pull-Working,Other Working,W-Cross Charges,0,0,0,0,0,0,0
LAB Mexico,Mexico,2024,CSD,Pepsi,Pull-Working,Other Working,W-Excluded non-A&M Items,0,0,0,0,0,0,0
LAB Mexico,Mexico,2024,CSD,Pepsi,Pull-Working,Other Working,W-Fall In / Fall Out,0,0,0,0,0,0,0
LAB Mexico,Mexico,2024,CSD,Pepsi,Pull-Working,Sampling,Other Sampling,0,0,0,0,0,0,0
LAB Mexico,Mexico,2024,CSD,Pepsi,Pull-Working,Sampling,Product Samples,100,824194,812622,11572,46052,45405,647
LAB Mexico,Mexico,2024,CSD,Pepsi,Pull-Working,Sampling,Sample Executing,100,11926029,11926029,0,666371,666371,0
LAB Mexico,Mexico,2024,CSD,Pepsi,Pull-Working,Sponsorships,Other Sponsorships,0,0,0,0,0,0,0
LAB Mexico,Mexico,2024,CSD,Pepsi,Pull-Working,Sponsorships,Sponsorships,100,97592009,97592009,0,5452993,5452993,0
LAB Mexico,Mexico,2024,CSD,Pepsi,STB - Push,Capability Building/Other,Capability Building,0,32292109,0,32292109,1804334,0,1804334
LAB Mexico,Mexico,2024,CSD,Pepsi,STB - Push,Capability Building/Other,Capability Building/Other-Other,0,0,0,0,0,0,0
LAB Mexico,Mexico,2024,CSD,Pepsi,STB - Push,Trade Equipment,On Premise Equipment,0,37158841,0,37158841,2076265,0,2076265
LAB Mexico,Mexico,2024,CSD,Pepsi,STB - Push,Trade Equipment,"Stands/ Racks, Other Trade Equipment",0,2852500,0,2852500,159384,0,159384
LAB Mexico,Mexico,2024,CSD,Pepsi,STB - Push,Trade Equipment,Trade Equipment-Other,0,0,0,0,0,0,0
LAB Mexico,Mexico,2024,CSD,Pepsi,STB - Push,Trade Programs,Distribution Incentives,0,252776379,0,252776379,14123982,0,14123982
LAB Mexico,Mexico,2024,CSD,Pepsi,STB - Push,Trade Programs,Innovation Investments,0,0,0,0,0,0,0
LAB Mexico,Mexico,2024,CSD,Pepsi,STB - Push,Trade Programs,Other Trade Programs,0,0,0,0,0,0,0
LAB Mexico,Mexico,2024,CSD,Pepsi,STB - Push,Trade Programs,Sales Incentives,0,0,0,0,0,0,0
LAB Mexico,Mexico,2024,CSD,Pepsi,STB - Push,Trade Programs,Space Investments,0,63246633,0,63246633,3533931,0,3533931
LAB Mexico,Mexico,2024,CSD,Pepsi,STB - Push,Unilateral,CDAs,0,629619672,0,629619672,35180254,0,35180254
LAB Mexico,Mexico,2024,CSD,Pepsi,STB - Push,Unilateral,Capital Equipment,0,557,0,557,31,0,31
LAB Mexico,Mexico,2024,CSD,Pepsi,STB - Push,Unilateral,Other Unilateral,0,0,0,0,0,0,0
LAB Mexico,Mexico,2024,CSD,Pepsi,STB - Push,Unilateral,Price Support,0,0,0,0,0,0,0
LAB Mexico,Mexico,2024,Others,Sabores,Pull-Non-Working,Ad Production,Digital Ad Production,100,30,30,0,1,1,0
LAB Mexico,Mexico,2024,Others,Sabores,Pull-Non-Working,Ad Production,Other Ad Production,0,0,0,0,0,0,0
LAB Mexico,Mexico,2024,Others,Sabores,Pull-Non-Working,Ad Production,TV Print Radio OOH Prod,100,2074422,2042435,31987,115909,114121,1788
LAB Mexico,Mexico,2024,Others,Sabores,Pull-Non-Working,Agency Fees,Creative Agency Fees,0,0,0,0,0,0,0
LAB Mexico,Mexico,2024,Others,Sabores,Pull-Non-Working,Agency Fees,In Store and POS Design/Development,0,0,0,0,0,0,0
LAB Mexico,Mexico,2024,Others,Sabores,Pull-Non-Working,Agency Fees,Media Agency Fees,100,4689910,4689910,0,262050,262050,0
LAB Mexico,Mexico,2024,Others,Sabores,Pull-Non-Working,Agency Fees,Other Agency Fees,0,0,0,0,0,0,0
LAB Mexico,Mexico,2024,Others,Sabores,Pull-Non-Working,Agency Fees,Social Media/Influence Marketing,0,0,0,0,0,0,0
LAB Mexico,Mexico,2024,Others,Sabores,Pull-Non-Working,Innovation and Insight,Innovation,0,0,0,0,0,0,0
LAB Mexico,Mexico,2024,Others,Sabores,Pull-Non-Working,Innovation and Insight,Market Research,0,0,0,0,0,0,0
LAB Mexico,Mexico,2024,Others,Sabores,Pull-Non-Working,Innovation and Insight,Other Innovation and Insight,0,0,0,0,0,0,0
LAB Mexico,Mexico,2024,Others,Sabores,Pull-Non-Working,Insight,Advanced Analytics,100,7232903,7232903,0,404141,404141,0
LAB Mexico,Mexico,2024,Others,Sabores,Pull-Non-Working,Insight,Brand Building,0,0,0,0,0,0,0
LAB Mexico,Mexico,2024,Others,Sabores,Pull-Non-Working,Insight,Consumer Tracking,100,3732401,3553747,178654,208549,198567,9982
LAB Mexico,Mexico,2024,Others,Sabores,Pull-Non-Working,Insight,Customer / Retail and Insights and Analytics,100,96654,96293,361,5400,5380,20
LAB Mexico,Mexico,2024,Others,Sabores,Pull-Non-Working,Insight,Foundational Data / Systems,0,0,0,0,0,0,0
LAB Mexico,Mexico,2024,Others,Sabores,Pull-Non-Working,Insight,Innovation Insights,0,0,0,0,0,0,0
LAB Mexico,Mexico,2024,Others,Sabores,Pull-Non-Working,Insight,Strategic Insights,100,2391386,2295116,96270,133619,128240,5379
LAB Mexico,Mexico,2024,Others,Sabores,Pull-Non-Working,Other Non Working,All Other Non Working,100,11620944,11620944,0,649324,649324,0
LAB Mexico,Mexico,2024,Others,Sabores,Pull-Non-Working,Other Non Working,NW-Cross Charges,0,0,0,0,0,0,0
LAB Mexico,Mexico,2024,Others,Sabores,Pull-Non-Working,Other Non Working,NW-Excluded non-A&M Items,0,0,0,0,0,0,0
LAB Mexico,Mexico,2024,Others,Sabores,Pull-Non-Working,Other Non Working,NW-Fall In / Fall Out,0,0,0,0,0,0,0
LAB Mexico,Mexico,2024,Others,Sabores,Pull-Non-Working,Other Non Working,Out of Scope Countries ( D8 Gastos),0,0,0,0,0,0,0
LAB Mexico,Mexico,2024,Others,Sabores,Pull-Non-Working,Package Design,Other Package Design,0,0,0,0,0,0,0
LAB Mexico,Mexico,2024,Others,Sabores,Pull-Non-Working,Package Design,Package Design,0,0,0,0,0,0,0
LAB Mexico,Mexico,2024,Others,Sabores,Pull-Working,Consumer Promotions,Consumer Promotions Execution,0,188170708,0,188170708,10514114,0,10514114
LAB Mexico,Mexico,2024,Others,Sabores,Pull-Working,Consumer Promotions,Coupons (Redemption),0,26,0,26,1,0,1
LAB Mexico,Mexico,2024,Others,Sabores,Pull-Working,Consumer Promotions,Other Consumer Promotions,0,0,0,0,0,0,0
LAB Mexico,Mexico,2024,Others,Sabores,Pull-Working,Consumer Promotions,Premiums,100,7917422,7650363,267059,442389,427467,14922
LAB Mexico,Mexico,2024,Others,Sabores,Pull-Working,In Store & POS Execution,In-Store and POS Execution,100,14992772,14532726,460046,837727,812021,25706
LAB Mexico,Mexico,2024,Others,Sabores,Pull-Working,In Store & POS Execution,Other In-Store and POS Execution,0,0,0,0,0,0,0
LAB Mexico,Mexico,2024,Others,Sabores,Pull-Working,Media Placements,Digital Media,0,0,0,0,0,0,0
LAB Mexico,Mexico,2024,Others,Sabores,Pull-Working,Media Placements,Media Placements,100,38102128,38102128,0,2128971,2128971,0
LAB Mexico,Mexico,2024,Others,Sabores,Pull-Working,Media Placements,Other Media,100,236214,236214,0,13198,13198,0
LAB Mexico,Mexico,2024,Others,Sabores,Pull-Working,Other Working,All Other Working,100,3378697,3378697,0,188786,188786,0
LAB Mexico,Mexico,2024,Others,Sabores,Pull-Working,Other Working,W-Cross Charges,0,0,0,0,0,0,0
LAB Mexico,Mexico,2024,Others,Sabores,Pull-Working,Other Working,W-Excluded non-A&M Items,0,0,0,0,0,0,0
LAB Mexico,Mexico,2024,Others,Sabores,Pull-Working,Other Working,W-Fall In / Fall Out,0,0,0,0,0,0,0
LAB Mexico,Mexico,2024,Others,Sabores,Pull-Working,Sampling,Other Sampling,0,0,0,0,0,0,0
LAB Mexico,Mexico,2024,Others,Sabores,Pull-Working,Sampling,Product Samples,100,143773,143773,0,8033,8033,0
LAB Mexico,Mexico,2024,Others,Sabores,Pull-Working,Sampling,Sample Executing,100,2110115,1992952,117163,117903,111357,6546
LAB Mexico,Mexico,2024,Others,Sabores,Pull-Working,Sponsorships,Other Sponsorships,0,0,0,0,0,0,0
LAB Mexico,Mexico,2024,Others,Sabores,Pull-Working,Sponsorships,Sponsorships,100,17151629,17151629,0,958354,958354,0
LAB Mexico,Mexico,2024,Others,Sabores,STB - Push,Capability Building/Other,Capability Building,0,5597501,0,5597501,312762,0,312762
LAB Mexico,Mexico,2024,Others,Sabores,STB - Push,Capability Building/Other,Capability Building/Other-Other,0,0,0,0,0,0,0
LAB Mexico,Mexico,2024,Others,Sabores,STB - Push,Trade Equipment,On Premise Equipment,0,6701019,0,6701019,374422,0,374422
LAB Mexico,Mexico,2024,Others,Sabores,STB - Push,Trade Equipment,"Stands/ Racks, Other Trade Equipment",0,481702,0,481702,26915,0,26915
LAB Mexico,Mexico,2024,Others,Sabores,STB - Push,Trade Equipment,Trade Equipment-Other,0,0,0,0,0,0,0
LAB Mexico,Mexico,2024,Others,Sabores,STB - Push,Trade Programs,Distribution Incentives,0,45858843,0,45858843,2562381,0,2562381
LAB Mexico,Mexico,2024,Others,Sabores,STB - Push,Trade Programs,Innovation Investments,0,0,0,0,0,0,0
LAB Mexico,Mexico,2024,Others,Sabores,STB - Push,Trade Programs,Other Trade Programs,0,0,0,0,0,0,0
LAB Mexico,Mexico,2024,Others,Sabores,STB - Push,Trade Programs,Sales Incentives,0,0,0,0,0,0,0
LAB Mexico,Mexico,2024,Others,Sabores,STB - Push,Trade Programs,Space Investments,0,11382996,0,11382996,636029,0,636029
LAB Mexico,Mexico,2024,Others,Sabores,STB - Push,Unilateral,CDAs,0,111212976,0,111212976,6214070,0,6214070
LAB Mexico,Mexico,2024,Others,Sabores,STB - Push,Unilateral,Capital Equipment,0,0,0,0,0,0,0
LAB Mexico,Mexico,2024,Others,Sabores,STB - Push,Unilateral,Other Unilateral,0,0,0,0,0,0,0
LAB Mexico,Mexico,2024,Others,Sabores,STB - Push,Unilateral,Price Support,0,0,0,0,0,0,0
LAB North,Nicaragua,2024,Energy Drinks,Adrenaline,Pull-Non-Working,Ad Production,Digital Ad Production,0,0,0,0,0,0,0
LAB North,Nicaragua,2024,Energy Drinks,Adrenaline,Pull-Non-Working,Ad Production,"TV, Print, Radio, OOH, Production",0,0,0,0,0,0,0
LAB North,Nicaragua,2024,Energy Drinks,Adrenaline,Pull-Non-Working,Agency Fees,Creative Agency Fees,0,0,0,0,0,0,0
LAB North,Nicaragua,2024,Energy Drinks,Adrenaline,Pull-Non-Working,Agency Fees,In Store & POS Design / Development,0,0,0,0,0,0,0
LAB North,Nicaragua,2024,Energy Drinks,Adrenaline,Pull-Non-Working,Agency Fees,Media Agency Fees,0,0,0,0,0,0,0
LAB North,Nicaragua,2024,Energy Drinks,Adrenaline,Pull-Non-Working,Agency Fees,Other,0,0,0,0,0,0,0
LAB North,Nicaragua,2024,Energy Drinks,Adrenaline,Pull-Non-Working,Agency Fees,Social Media / Influence Marketing,0,0,0,0,0,0,0
LAB North,Nicaragua,2024,Energy Drinks,Adrenaline,Pull-Non-Working,All Other Non-Working,Administrative fees,0,0,0,0,0,0,0
LAB North,Nicaragua,2024,Energy Drinks,Adrenaline,Pull-Non-Working,All Other Non-Working,Agency out of pocket,0,0,0,0,0,0,0
LAB North,Nicaragua,2024,Energy Drinks,Adrenaline,Pull-Non-Working,All Other Non-Working,CP out of pocket admin,0,0,0,0,0,0,0
LAB North,Nicaragua,2024,Energy Drinks,Adrenaline,Pull-Non-Working,All Other Non-Working,Grassroots/experiential out of pocket,0,0,0,0,0,0,0
LAB North,Nicaragua,2024,Energy Drinks,Adrenaline,Pull-Non-Working,All Other Non-Working,League/property- rights fee/options,0,0,0,0,0,0,0
LAB North,Nicaragua,2024,Energy Drinks,Adrenaline,Pull-Non-Working,All Other Non-Working,Market Research,0,0,0,0,0,0,0
LAB North,Nicaragua,2024,Energy Drinks,Adrenaline,Pull-Non-Working,All Other Non-Working,Non-allocated NW,0,0,0,0,0,0,0
LAB North,Nicaragua,2024,Energy Drinks,Adrenaline,Pull-Non-Working,All Other Non-Working,Other Non Working-non itemised talent,0,0,0,0,0,0,0
LAB North,Nicaragua,2024,Energy Drinks,Adrenaline,Pull-Non-Working,All Other Non-Working,PR out of pocket administrative,0,0,0,0,0,0,0
LAB North,Nicaragua,2024,Energy Drinks,Adrenaline,Pull-Non-Working,Innovation and Insight,Innovations,0,0,0,0,0,0,0
LAB North,Nicaragua,2024,Energy Drinks,Adrenaline,Pull-Non-Working,Innovation and Insight,Market Research,0,0,0,0,0,0,0
LAB North,Nicaragua,2024,Energy Drinks,Adrenaline,Pull-Non-Working,Package Design,Package design,0,0,0,0,0,0,0
LAB North,Nicaragua,2024,Energy Drinks,Adrenaline,Pull-Non-Working,Package Design,Package development,0,0,0,0,0,0,0
LAB North,Nicaragua,2024,Energy Drinks,Adrenaline,STB - Push,Capability Building/Other,Capability Building Other,0,0,0,0,0,0,0
LAB North,Nicaragua,2024,Energy Drinks,Adrenaline,STB - Push,Other Investments,CDA's,50,4430,2202,2228,121,60,61
LAB North,Nicaragua,2024,Energy Drinks,Adrenaline,STB - Push,Other Investments,Capital (Coolers),0,0,0,0,0,0,0
LAB North,Nicaragua,2024,Energy Drinks,Adrenaline,STB - Push,Other Investments,Price Support,0,0,0,0,0,0,0
LAB North,Nicaragua,2024,Energy Drinks,Adrenaline,STB - Push,Other Investments,Vending / Racks,0,0,0,0,0,0,0
LAB North,Nicaragua,2024,Energy Drinks,Adrenaline,STB - Push,Other Trade,Frozen Funds,0,0,0,0,0,0,0
LAB North,Nicaragua,2024,Energy Drinks,Adrenaline,STB - Push,Other Trade,Other Trade,0,0,0,0,0,0,0
LAB North,Nicaragua,2024,Energy Drinks,Adrenaline,STB - Push,Trade Equipment,Coolers - New,0,0,0,0,0,0,0
LAB North,Nicaragua,2024,Energy Drinks,Adrenaline,STB - Push,Trade Equipment,Coolers - Refurbished,0,0,0,0,0,0,0
LAB North,Nicaragua,2024,Energy Drinks,Adrenaline,STB - Push,Trade Equipment,Post Mix / Pre Mix Equip.,0,0,0,0,0,0,0
LAB North,Nicaragua,2024,Energy Drinks,Adrenaline,STB - Push,Trade Equipment,Vending / Racks,0,0,0,0,0,0,0
LAB North,Nicaragua,2024,Energy Drinks,Adrenaline,STB - Push,Trade Programs,Distribution Incentives,0,0,0,0,0,0,0
LAB North,Nicaragua,2024,Energy Drinks,Adrenaline,STB - Push,Trade Programs,Innovation Investments,0,0,0,0,0,0,0
LAB North,Nicaragua,2024,Energy Drinks,Adrenaline,STB - Push,Trade Programs,Sales Incentives,0,0,0,0,0,0,0
LAB North,Nicaragua,2024,Energy Drinks,Adrenaline,STB - Push,Trade Programs,Space Investments,0,0,0,0,0,0,0
LAB North,Nicaragua,2024,Energy Drinks,Adrenaline,Pull-Working,All Other Working,Other Working - PR execution,50,37193,19669,17524,1019,538,481
LAB North,Nicaragua,2024,Energy Drinks,Adrenaline,Pull-Working,All Other Working,Other Working - activation,0,0,0,0,0,0,0
LAB North,Nicaragua,2024,Energy Drinks,Adrenaline,Pull-Working,All Other Working,Other Working - non allocated working,0,0,0,0,0,0,0
LAB North,Nicaragua,2024,Energy Drinks,Adrenaline,Pull-Working,Consumer Promotions,Consumer Promotions Execution,0,0,0,0,0,0,0
LAB North,Nicaragua,2024,Energy Drinks,Adrenaline,Pull-Working,Consumer Promotions,Coupons,0,0,0,0,0,0,0
LAB North,Nicaragua,2024,Energy Drinks,Adrenaline,Pull-Working,Consumer Promotions,Other,0,0,0,0,0,0,0
LAB North,Nicaragua,2024,Energy Drinks,Adrenaline,Pull-Working,Consumer Promotions,Premiums,50,7234,3715,3519,198,101,97
LAB North,Nicaragua,2024,Energy Drinks,Adrenaline,Pull-Working,In Store & POS Execution,In-Store & POS Execution,50,2862,1433,1429,78,39,39
LAB North,Nicaragua,2024,Energy Drinks,Adrenaline,Pull-Working,Media Placements,Cinema,0,0,0,0,0,0,0
LAB North,Nicaragua,2024,Energy Drinks,Adrenaline,Pull-Working,Media Placements,Digital,0,0,0,0,0,0,0
LAB North,Nicaragua,2024,Energy Drinks,Adrenaline,Pull-Working,Media Placements,OOH - Out Of Home,0,0,0,0,0,0,0
LAB North,Nicaragua,2024,Energy Drinks,Adrenaline,Pull-Working,Media Placements,Other,0,0,0,0,0,0,0
LAB North,Nicaragua,2024,Energy Drinks,Adrenaline,Pull-Working,Media Placements,Print,50,11715,5766,5949,320,157,163
LAB North,Nicaragua,2024,Energy Drinks,Adrenaline,Pull-Working,Media Placements,Radio,0,0,0,0,0,0,0
LAB North,Nicaragua,2024,Energy Drinks,Adrenaline,Pull-Working,Media Placements,TV,0,0,0,0,0,0,0
LAB North,Nicaragua,2024,Energy Drinks,Adrenaline,Pull-Working,Sampling,Product Samples,50,13233,6325,6908,362,173,189
LAB North,Nicaragua,2024,Energy Drinks,Adrenaline,Pull-Working,Sampling,Sampling Execution,0,0,0,0,0,0,0
LAB North,Nicaragua,2024,Energy Drinks,Adrenaline,Pull-Working,Sponsorships,Sponsorships-in game/ in show,50,2949,1434,1515,80,39,41
LAB North,Nicaragua,2024,Energy Drinks,Adrenaline,Pull-Working,Sponsorships,Sports-athlete/team contracts,0,0,0,0,0,0,0
LAB North,Nicaragua,2024,Energy Drinks,Adrenaline,Pull-Working,Sponsorships,Sports-on field or in show props,0,0,0,0,0,0,0
LAB North,Nicaragua,2024,Energy Drinks,Adrenaline,Pull-Working,Sponsorships,Sports-stadium contracts,0,0,0,0,0,0,0
LAB North,Nicaragua,2024,Water,Aquafina,Pull-Non-Working,Ad Production,Digital Ad Production,0,0,0,0,0,0,0
LAB North,Nicaragua,2024,Water,Aquafina,Pull-Non-Working,Ad Production,"TV, Print, Radio, OOH, Production",0,0,0,0,0,0,0
LAB North,Nicaragua,2024,Water,Aquafina,Pull-Non-Working,Agency Fees,Creative Agency Fees,0,0,0,0,0,0,0
LAB North,Nicaragua,2024,Water,Aquafina,Pull-Non-Working,Agency Fees,In Store & POS Design / Development,0,0,0,0,0,0,0
LAB North,Nicaragua,2024,Water,Aquafina,Pull-Non-Working,Agency Fees,Media Agency Fees,0,0,0,0,0,0,0
LAB North,Nicaragua,2024,Water,Aquafina,Pull-Non-Working,Agency Fees,Other,0,0,0,0,0,0,0
LAB North,Nicaragua,2024,Water,Aquafina,Pull-Non-Working,Agency Fees,Social Media / Influence Marketing,0,0,0,0,0,0,0
LAB North,Nicaragua,2024,Water,Aquafina,Pull-Non-Working,All Other Non-Working,Administrative fees,0,0,0,0,0,0,0
LAB North,Nicaragua,2024,Water,Aquafina,Pull-Non-Working,All Other Non-Working,Agency out of pocket,0,0,0,0,0,0,0
LAB North,Nicaragua,2024,Water,Aquafina,Pull-Non-Working,All Other Non-Working,CP out of pocket admin,0,0,0,0,0,0,0
LAB North,Nicaragua,2024,Water,Aquafina,Pull-Non-Working,All Other Non-Working,Grassroots/experiential out of pocket,0,0,0,0,0,0,0
LAB North,Nicaragua,2024,Water,Aquafina,Pull-Non-Working,All Other Non-Working,League/property- rights fee/options,0,0,0,0,0,0,0
LAB North,Nicaragua,2024,Water,Aquafina,Pull-Non-Working,All Other Non-Working,Market Research,0,0,0,0,0,0,0
LAB North,Nicaragua,2024,Water,Aquafina,Pull-Non-Working,All Other Non-Working,Non-allocated NW,0,0,0,0,0,0,0
LAB North,Nicaragua,2024,Water,Aquafina,Pull-Non-Working,All Other Non-Working,Other Non Working-non itemised talent,0,0,0,0,0,0,0
LAB North,Nicaragua,2024,Water,Aquafina,Pull-Non-Working,All Other Non-Working,PR out of pocket administrative,0,0,0,0,0,0,0
LAB North,Nicaragua,2024,Water,Aquafina,Pull-Non-Working,Innovation and Insight,Innovations,0,0,0,0,0,0,0
LAB North,Nicaragua,2024,Water,Aquafina,Pull-Non-Working,Innovation and Insight,Market Research,50,1411,723,688,38,19,19
LAB North,Nicaragua,2024,Water,Aquafina,Pull-Non-Working,Package Design,Package design,0,0,0,0,0,0,0
LAB North,Nicaragua,2024,Water,Aquafina,Pull-Non-Working,Package Design,Package development,0,0,0,0,0,0,0
LAB North,Nicaragua,2024,Water,Aquafina,STB - Push,Capability Building/Other,Capability Building Other,0,0,0,0,0,0,0
LAB North,Nicaragua,2024,Water,Aquafina,STB - Push,Other Investments,CDA's,50,19352,9745,9607,530,267,263
LAB North,Nicaragua,2024,Water,Aquafina,STB - Push,Other Investments,Capital (Coolers),0,0,0,0,0,0,0
LAB North,Nicaragua,2024,Water,Aquafina,STB - Push,Other Investments,Price Support,0,0,0,0,0,0,0
LAB North,Nicaragua,2024,Water,Aquafina,STB - Push,Other Investments,Vending / Racks,0,0,0,0,0,0,0
LAB North,Nicaragua,2024,Water,Aquafina,STB - Push,Other Trade,Frozen Funds,0,0,0,0,0,0,0
LAB North,Nicaragua,2024,Water,Aquafina,STB - Push,Other Trade,Other Trade,0,0,0,0,0,0,0
LAB North,Nicaragua,2024,Water,Aquafina,STB - Push,Trade Equipment,Coolers - New,0,0,0,0,0,0,0
LAB North,Nicaragua,2024,Water,Aquafina,STB - Push,Trade Equipment,Coolers - Refurbished,0,0,0,0,0,0,0
LAB North,Nicaragua,2024,Water,Aquafina,STB - Push,Trade Equipment,Post Mix / Pre Mix Equip.,0,0,0,0,0,0,0
LAB North,Nicaragua,2024,Water,Aquafina,STB - Push,Trade Equipment,Vending / Racks,0,0,0,0,0,0,0
LAB North,Nicaragua,2024,Water,Aquafina,STB - Push,Trade Programs,Distribution Incentives,0,0,0,0,0,0,0
LAB North,Nicaragua,2024,Water,Aquafina,STB - Push,Trade Programs,Innovation Investments,0,0,0,0,0,0,0
LAB North,Nicaragua,2024,Water,Aquafina,STB - Push,Trade Programs,Sales Incentives,0,0,0,0,0,0,0
LAB North,Nicaragua,2024,Water,Aquafina,STB - Push,Trade Programs,Space Investments,0,0,0,0,0,0,0
LAB North,Nicaragua,2024,Water,Aquafina,Pull-Working,All Other Working,Other Working - PR execution,50,51981,25880,26101,1424,709,715
LAB North,Nicaragua,2024,Water,Aquafina,Pull-Working,All Other Working,Other Working - activation,0,0,0,0,0,0,0
LAB North,Nicaragua,2024,Water,Aquafina,Pull-Working,All Other Working,Other Working - non allocated working,0,0,0,0,0,0,0
LAB North,Nicaragua,2024,Water,Aquafina,Pull-Working,Consumer Promotions,Consumer Promotions Execution,0,0,0,0,0,0,0
LAB North,Nicaragua,2024,Water,Aquafina,Pull-Working,Consumer Promotions,Coupons,0,0,0,0,0,0,0
LAB North,Nicaragua,2024,Water,Aquafina,Pull-Working,Consumer Promotions,Other,0,0,0,0,0,0,0
LAB North,Nicaragua,2024,Water,Aquafina,Pull-Working,Consumer Promotions,Premiums,50,29828,14900,14928,817,408,409
LAB North,Nicaragua,2024,Water,Aquafina,Pull-Working,In Store & POS Execution,In-Store & POS Execution,50,28520,14922,13598,781,408,373
LAB North,Nicaragua,2024,Water,Aquafina,Pull-Working,Media Placements,Cinema,0,0,0,0,0,0,0
LAB North,Nicaragua,2024,Water,Aquafina,Pull-Working,Media Placements,Digital,50,3545,1782,1763,97,48,49
LAB North,Nicaragua,2024,Water,Aquafina,Pull-Working,Media Placements,OOH - Out Of Home,0,0,0,0,0,0,0
LAB North,Nicaragua,2024,Water,Aquafina,Pull-Working,Media Placements,Other,0,0,0,0,0,0,0
LAB North,Nicaragua,2024,Water,Aquafina,Pull-Working,Media Placements,Print,50,29270,14642,14628,801,401,400
LAB North,Nicaragua,2024,Water,Aquafina,Pull-Working,Media Placements,Radio,0,0,0,0,0,0,0
LAB North,Nicaragua,2024,Water,Aquafina,Pull-Working,Media Placements,TV,0,0,0,0,0,0,0
LAB North,Nicaragua,2024,Water,Aquafina,Pull-Working,Sampling,Product Samples,50,14428,7281,7147,395,199,196
LAB North,Nicaragua,2024,Water,Aquafina,Pull-Working,Sampling,Sampling Execution,0,0,0,0,0,0,0
LAB North,Nicaragua,2024,Water,Aquafina,Pull-Working,Sponsorships,Sponsorships-in game/ in show,50,28356,14861,13495,776,407,369
LAB North,Nicaragua,2024,Water,Aquafina,Pull-Working,Sponsorships,Sports-athlete/team contracts,0,0,0,0,0,0,0
LAB North,Nicaragua,2024,Water,Aquafina,Pull-Working,Sponsorships,Sports-on field or in show props,0,0,0,0,0,0,0
LAB North,Nicaragua,2024,Water,Aquafina,Pull-Working,Sponsorships,Sports-stadium contracts,0,0,0,0,0,0,0
LAB North,Nicaragua,2024,Energy Drinks,Kickstart,Pull-Non-Working,Ad Production,Digital Ad Production,0,0,0,0,0,0,0
LAB North,Nicaragua,2024,Energy Drinks,Kickstart,Pull-Non-Working,Ad Production,"TV, Print, Radio, OOH, Production",0,0,0,0,0,0,0
LAB North,Nicaragua,2024,Energy Drinks,Kickstart,Pull-Non-Working,Agency Fees,Creative Agency Fees,0,0,0,0,0,0,0
LAB North,Nicaragua,2024,Energy Drinks,Kickstart,Pull-Non-Working,Agency Fees,In Store & POS Design / Development,0,0,0,0,0,0,0
LAB North,Nicaragua,2024,Energy Drinks,Kickstart,Pull-Non-Working,Agency Fees,Media Agency Fees,0,0,0,0,0,0,0
LAB North,Nicaragua,2024,Energy Drinks,Kickstart,Pull-Non-Working,Agency Fees,Other,0,0,0,0,0,0,0
LAB North,Nicaragua,2024,Energy Drinks,Kickstart,Pull-Non-Working,Agency Fees,Social Media / Influence Marketing,0,0,0,0,0,0,0
LAB North,Nicaragua,2024,Energy Drinks,Kickstart,Pull-Non-Working,All Other Non-Working,Administrative fees,0,0,0,0,0,0,0
LAB North,Nicaragua,2024,Energy Drinks,Kickstart,Pull-Non-Working,All Other Non-Working,Agency out of pocket,0,0,0,0,0,0,0
LAB North,Nicaragua,2024,Energy Drinks,Kickstart,Pull-Non-Working,All Other Non-Working,CP out of pocket admin,0,0,0,0,0,0,0
LAB North,Nicaragua,2024,Energy Drinks,Kickstart,Pull-Non-Working,All Other Non-Working,Grassroots/experiential out of pocket,0,0,0,0,0,0,0
LAB North,Nicaragua,2024,Energy Drinks,Kickstart,Pull-Non-Working,All Other Non-Working,League/property- rights fee/options,0,0,0,0,0,0,0
LAB North,Nicaragua,2024,Energy Drinks,Kickstart,Pull-Non-Working,All Other Non-Working,Market Research,0,0,0,0,0,0,0
LAB North,Nicaragua,2024,Energy Drinks,Kickstart,Pull-Non-Working,All Other Non-Working,Non-allocated NW,0,0,0,0,0,0,0
LAB North,Nicaragua,2024,Energy Drinks,Kickstart,Pull-Non-Working,All Other Non-Working,Other Non Working-non itemised talent,0,0,0,0,0,0,0
LAB North,Nicaragua,2024,Energy Drinks,Kickstart,Pull-Non-Working,All Other Non-Working,PR out of pocket administrative,0,0,0,0,0,0,0
LAB North,Nicaragua,2024,Energy Drinks,Kickstart,Pull-Non-Working,Innovation and Insight,Innovations,0,0,0,0,0,0,0
LAB North,Nicaragua,2024,Energy Drinks,Kickstart,Pull-Non-Working,Innovation and Insight,Market Research,0,0,0,0,0,0,0
LAB North,Nicaragua,2024,Energy Drinks,Kickstart,Pull-Non-Working,Package Design,Package design,0,0,0,0,0,0,0
LAB North,Nicaragua,2024,Energy Drinks,Kickstart,Pull-Non-Working,Package Design,Package development,0,0,0,0,0,0,0
LAB North,Nicaragua,2024,Energy Drinks,Kickstart,STB - Push,Capability Building/Other,Capability Building Other,0,0,0,0,0,0,0
LAB North,Nicaragua,2024,Energy Drinks,Kickstart,STB - Push,Other Investments,CDA's,50,23719,11206,12513,649,307,342
LAB North,Nicaragua,2024,Energy Drinks,Kickstart,STB - Push,Other Investments,Capital (Coolers),0,0,0,0,0,0,0
LAB North,Nicaragua,2024,Energy Drinks,Kickstart,STB - Push,Other Investments,Price Support,0,0,0,0,0,0,0
LAB North,Nicaragua,2024,Energy Drinks,Kickstart,STB - Push,Other Investments,Vending / Racks,0,0,0,0,0,0,0
LAB North,Nicaragua,2024,Energy Drinks,Kickstart,STB - Push,Other Trade,Frozen Funds,0,0,0,0,0,0,0
LAB North,Nicaragua,2024,Energy Drinks,Kickstart,STB - Push,Other Trade,Other Trade,0,0,0,0,0,0,0
LAB North,Nicaragua,2024,Energy Drinks,Kickstart,STB - Push,Trade Equipment,Coolers - New,0,0,0,0,0,0,0
LAB North,Nicaragua,2024,Energy Drinks,Kickstart,STB - Push,Trade Equipment,Coolers - Refurbished,0,0,0,0,0,0,0
LAB North,Nicaragua,2024,Energy Drinks,Kickstart,STB - Push,Trade Equipment,Post Mix / Pre Mix Equip.,0,0,0,0,0,0,0
LAB North,Nicaragua,2024,Energy Drinks,Kickstart,STB - Push,Trade Equipment,Vending / Racks,0,0,0,0,0,0,0
LAB North,Nicaragua,2024,Energy Drinks,Kickstart,STB - Push,Trade Programs,Distribution Incentives,0,0,0,0,0,0,0
LAB North,Nicaragua,2024,Energy Drinks,Kickstart,STB - Push,Trade Programs,Innovation Investments,0,0,0,0,0,0,0
LAB North,Nicaragua,2024,Energy Drinks,Kickstart,STB - Push,Trade Programs,Sales Incentives,0,0,0,0,0,0,0
LAB North,Nicaragua,2024,Energy Drinks,Kickstart,STB - Push,Trade Programs,Space Investments,0,0,0,0,0,0,0
LAB North,Nicaragua,2024,Energy Drinks,Kickstart,Pull-Working,All Other Working,Other Working - PR execution,0,0,0,0,0,0,0
LAB North,Nicaragua,2024,Energy Drinks,Kickstart,Pull-Working,All Other Working,Other Working - activation,0,0,0,0,0,0,0
LAB North,Nicaragua,2024,Energy Drinks,Kickstart,Pull-Working,All Other Working,Other Working - non allocated working,0,0,0,0,0,0,0
LAB North,Nicaragua,2024,Energy Drinks,Kickstart,Pull-Working,Consumer Promotions,Consumer Promotions Execution,0,0,0,0,0,0,0
LAB North,Nicaragua,2024,Energy Drinks,Kickstart,Pull-Working,Consumer Promotions,Coupons,0,0,0,0,0,0,0
LAB North,Nicaragua,2024,Energy Drinks,Kickstart,Pull-Working,Consumer Promotions,Other,0,0,0,0,0,0,0
LAB North,Nicaragua,2024,Energy Drinks,Kickstart,Pull-Working,Consumer Promotions,Premiums,0,0,0,0,0,0,0
LAB North,Nicaragua,2024,Energy Drinks,Kickstart,Pull-Working,In Store & POS Execution,In-Store & POS Execution,0,0,0,0,0,0,0
LAB North,Nicaragua,2024,Energy Drinks,Kickstart,Pull-Working,Media Placements,Cinema,0,0,0,0,0,0,0
LAB North,Nicaragua,2024,Energy Drinks,Kickstart,Pull-Working,Media Placements,Digital,0,0,0,0,0,0,0
LAB North,Nicaragua,2024,Energy Drinks,Kickstart,Pull-Working,Media Placements,OOH - Out Of Home,0,0,0,0,0,0,0
LAB North,Nicaragua,2024,Energy Drinks,Kickstart,Pull-Working,Media Placements,Other,0,0,0,0,0,0,0
LAB North,Nicaragua,2024,Energy Drinks,Kickstart,Pull-Working,Media Placements,Print,0,0,0,0,0,0,0
LAB North,Nicaragua,2024,Energy Drinks,Kickstart,Pull-Working,Media Placements,Radio,0,0,0,0,0,0,0
LAB North,Nicaragua,2024,Energy Drinks,Kickstart,Pull-Working,Media Placements,TV,0,0,0,0,0,0,0
LAB North,Nicaragua,2024,Energy Drinks,Kickstart,Pull-Working,Sampling,Product Samples,0,0,0,0,0,0,0
LAB North,Nicaragua,2024,Energy Drinks,Kickstart,Pull-Working,Sampling,Sampling Execution,0,0,0,0,0,0,0
LAB North,Nicaragua,2024,Energy Drinks,Kickstart,Pull-Working,Sponsorships,Sponsorships-in game/ in show,0,0,0,0,0,0,0
LAB North,Nicaragua,2024,Energy Drinks,Kickstart,Pull-Working,Sponsorships,Sports-athlete/team contracts,0,0,0,0,0,0,0
LAB North,Nicaragua,2024,Energy Drinks,Kickstart,Pull-Working,Sponsorships,Sports-on field or in show props,0,0,0,0,0,0,0
LAB North,Nicaragua,2024,Energy Drinks,Kickstart,Pull-Working,Sponsorships,Sports-stadium contracts,0,0,0,0,0,0,0
LAB North,Nicaragua,2024,RTD Tea,Lipton,Pull-Non-Working,Ad Production,Digital Ad Production,0,0,0,0,0,0,0
LAB North,Nicaragua,2024,RTD Tea,Lipton,Pull-Non-Working,Ad Production,"TV, Print, Radio, OOH, Production",0,0,0,0,0,0,0
LAB North,Nicaragua,2024,RTD Tea,Lipton,Pull-Non-Working,Agency Fees,Creative Agency Fees,0,0,0,0,0,0,0
LAB North,Nicaragua,2024,RTD Tea,Lipton,Pull-Non-Working,Agency Fees,In Store & POS Design / Development,0,0,0,0,0,0,0
LAB North,Nicaragua,2024,RTD Tea,Lipton,Pull-Non-Working,Agency Fees,Media Agency Fees,0,0,0,0,0,0,0
LAB North,Nicaragua,2024,RTD Tea,Lipton,Pull-Non-Working,Agency Fees,Other,0,0,0,0,0,0,0
LAB North,Nicaragua,2024,RTD Tea,Lipton,Pull-Non-Working,Agency Fees,Social Media / Influence Marketing,0,0,0,0,0,0,0
LAB North,Nicaragua,2024,RTD Tea,Lipton,Pull-Non-Working,All Other Non-Working,Administrative fees,0,0,0,0,0,0,0
LAB North,Nicaragua,2024,RTD Tea,Lipton,Pull-Non-Working,All Other Non-Working,Agency out of pocket,0,0,0,0,0,0,0
LAB North,Nicaragua,2024,RTD Tea,Lipton,Pull-Non-Working,All Other Non-Working,CP out of pocket admin,0,0,0,0,0,0,0
LAB North,Nicaragua,2024,RTD Tea,Lipton,Pull-Non-Working,All Other Non-Working,Grassroots/experiential out of pocket,0,0,0,0,0,0,0
LAB North,Nicaragua,2024,RTD Tea,Lipton,Pull-Non-Working,All Other Non-Working,League/property- rights fee/options,0,0,0,0,0,0,0
LAB North,Nicaragua,2024,RTD Tea,Lipton,Pull-Non-Working,All Other Non-Working,Market Research,0,0,0,0,0,0,0
LAB North,Nicaragua,2024,RTD Tea,Lipton,Pull-Non-Working,All Other Non-Working,Non-allocated NW,0,0,0,0,0,0,0
LAB North,Nicaragua,2024,RTD Tea,Lipton,Pull-Non-Working,All Other Non-Working,Other Non Working-non itemised talent,0,0,0,0,0,0,0
LAB North,Nicaragua,2024,RTD Tea,Lipton,Pull-Non-Working,All Other Non-Working,PR out of pocket administrative,0,0,0,0,0,0,0
LAB North,Nicaragua,2024,RTD Tea,Lipton,Pull-Non-Working,Innovation and Insight,Innovations,0,0,0,0,0,0,0
LAB North,Nicaragua,2024,RTD Tea,Lipton,Pull-Non-Working,Innovation and Insight,Market Research,0,0,0,0,0,0,0
LAB North,Nicaragua,2024,RTD Tea,Lipton,Pull-Non-Working,Package Design,Package design,0,0,0,0,0,0,0
LAB North,Nicaragua,2024,RTD Tea,Lipton,Pull-Non-Working,Package Design,Package development,0,0,0,0,0,0,0
LAB North,Nicaragua,2024,RTD Tea,Lipton,STB - Push,Capability Building/Other,Capability Building Other,0,0,0,0,0,0,0
LAB North,Nicaragua,2024,RTD Tea,Lipton,STB - Push,Other Investments,CDA's,50,21791,10979,10812,597,300,297
LAB North,Nicaragua,2024,RTD Tea,Lipton,STB - Push,Other Investments,Capital (Coolers),0,0,0,0,0,0,0
LAB North,Nicaragua,2024,RTD Tea,Lipton,STB - Push,Other Investments,Price Support,0,0,0,0,0,0,0
LAB North,Nicaragua,2024,RTD Tea,Lipton,STB - Push,Other Investments,Vending / Racks,0,0,0,0,0,0,0
LAB North,Nicaragua,2024,RTD Tea,Lipton,STB - Push,Other Trade,Frozen Funds,0,0,0,0,0,0,0
LAB North,Nicaragua,2024,RTD Tea,Lipton,STB - Push,Other Trade,Other Trade,0,0,0,0,0,0,0
LAB North,Nicaragua,2024,RTD Tea,Lipton,STB - Push,Trade Equipment,Coolers - New,0,0,0,0,0,0,0
LAB North,Nicaragua,2024,RTD Tea,Lipton,STB - Push,Trade Equipment,Coolers - Refurbished,0,0,0,0,0,0,0
LAB North,Nicaragua,2024,RTD Tea,Lipton,STB - Push,Trade Equipment,Post Mix / Pre Mix Equip.,0,0,0,0,0,0,0
LAB North,Nicaragua,2024,RTD Tea,Lipton,STB - Push,Trade Equipment,Vending / Racks,0,0,0,0,0,0,0
LAB North,Nicaragua,2024,RTD Tea,Lipton,STB - Push,Trade Programs,Distribution Incentives,0,0,0,0,0,0,0
LAB North,Nicaragua,2024,RTD Tea,Lipton,STB - Push,Trade Programs,Innovation Investments,0,0,0,0,0,0,0
LAB North,Nicaragua,2024,RTD Tea,Lipton,STB - Push,Trade Programs,Sales Incentives,0,0,0,0,0,0,0
LAB North,Nicaragua,2024,RTD Tea,Lipton,STB - Push,Trade Programs,Space Investments,0,0,0,0,0,0,0
LAB North,Nicaragua,2024,RTD Tea,Lipton,Pull-Working,All Other Working,Other Working - PR execution,50,23259,11370,11889,637,311,326
LAB North,Nicaragua,2024,RTD Tea,Lipton,Pull-Working,All Other Working,Other Working - activation,0,0,0,0,0,0,0
LAB North,Nicaragua,2024,RTD Tea,Lipton,Pull-Working,All Other Working,Other Working - non allocated working,0,0,0,0,0,0,0
LAB North,Nicaragua,2024,RTD Tea,Lipton,Pull-Working,Consumer Promotions,Consumer Promotions Execution,0,0,0,0,0,0,0
LAB North,Nicaragua,2024,RTD Tea,Lipton,Pull-Working,Consumer Promotions,Coupons,0,0,0,0,0,0,0
LAB North,Nicaragua,2024,RTD Tea,Lipton,Pull-Working,Consumer Promotions,Other,0,0,0,0,0,0,0
LAB North,Nicaragua,2024,RTD Tea,Lipton,Pull-Working,Consumer Promotions,Premiums,50,14346,7216,7130,393,197,196
LAB North,Nicaragua,2024,RTD Tea,Lipton,Pull-Working,In Store & POS Execution,In-Store & POS Execution,50,7001,3650,3351,191,100,91
LAB North,Nicaragua,2024,RTD Tea,Lipton,Pull-Working,Media Placements,Cinema,0,0,0,0,0,0,0
LAB North,Nicaragua,2024,RTD Tea,Lipton,Pull-Working,Media Placements,Digital,50,7481,3520,3961,204,96,108
LAB North,Nicaragua,2024,RTD Tea,Lipton,Pull-Working,Media Placements,OOH - Out Of Home,0,0,0,0,0,0,0
LAB North,Nicaragua,2024,RTD Tea,Lipton,Pull-Working,Media Placements,Other,0,0,0,0,0,0,0
LAB North,Nicaragua,2024,RTD Tea,Lipton,Pull-Working,Media Placements,Print,50,25787,13367,12420,706,366,340
LAB North,Nicaragua,2024,RTD Tea,Lipton,Pull-Working,Media Placements,Radio,0,0,0,0,0,0,0
LAB North,Nicaragua,2024,RTD Tea,Lipton,Pull-Working,Media Placements,TV,0,0,0,0,0,0,0
LAB North,Nicaragua,2024,RTD Tea,Lipton,Pull-Working,Sampling,Product Samples,50,10940,5369,5571,299,147,152
LAB North,Nicaragua,2024,RTD Tea,Lipton,Pull-Working,Sampling,Sampling Execution,0,0,0,0,0,0,0
LAB North,Nicaragua,2024,RTD Tea,Lipton,Pull-Working,Sponsorships,Sponsorships-in game/ in show,0,0,0,0,0,0,0
LAB North,Nicaragua,2024,RTD Tea,Lipton,Pull-Working,Sponsorships,Sports-athlete/team contracts,0,0,0,0,0,0,0
LAB North,Nicaragua,2024,RTD Tea,Lipton,Pull-Working,Sponsorships,Sports-on field or in show props,0,0,0,0,0,0,0
LAB North,Nicaragua,2024,RTD Tea,Lipton,Pull-Working,Sponsorships,Sports-stadium contracts,0,0,0,0,0,0,0
LAB North,Nicaragua,2024,CSD,Pepsi,Pull-Non-Working,Ad Production,Digital Ad Production,0,0,0,0,0,0,0
LAB North,Nicaragua,2024,CSD,Pepsi,Pull-Non-Working,Ad Production,"TV, Print, Radio, OOH, Production",0,0,0,0,0,0,0
LAB North,Nicaragua,2024,CSD,Pepsi,Pull-Non-Working,Agency Fees,Creative Agency Fees,0,0,0,0,0,0,0
LAB North,Nicaragua,2024,CSD,Pepsi,Pull-Non-Working,Agency Fees,In Store & POS Design / Development,0,0,0,0,0,0,0
LAB North,Nicaragua,2024,CSD,Pepsi,Pull-Non-Working,Agency Fees,Media Agency Fees,0,0,0,0,0,0,0
LAB North,Nicaragua,2024,CSD,Pepsi,Pull-Non-Working,Agency Fees,Other,0,0,0,0,0,0,0
LAB North,Nicaragua,2024,CSD,Pepsi,Pull-Non-Working,Agency Fees,Social Media / Influence Marketing,0,0,0,0,0,0,0
LAB North,Nicaragua,2024,CSD,Pepsi,Pull-Non-Working,All Other Non-Working,Administrative fees,0,0,0,0,0,0,0
LAB North,Nicaragua,2024,CSD,Pepsi,Pull-Non-Working,All Other Non-Working,Agency out of pocket,0,0,0,0,0,0,0
LAB North,Nicaragua,2024,CSD,Pepsi,Pull-Non-Working,All Other Non-Working,CP out of pocket admin,0,0,0,0,0,0,0
LAB North,Nicaragua,2024,CSD,Pepsi,Pull-Non-Working,All Other Non-Working,Grassroots/experiential out of pocket,0,0,0,0,0,0,0
LAB North,Nicaragua,2024,CSD,Pepsi,Pull-Non-Working,All Other Non-Working,League/property- rights fee/options,0,0,0,0,0,0,0
LAB North,Nicaragua,2024,CSD,Pepsi,Pull-Non-Working,All Other Non-Working,Market Research,0,0,0,0,0,0,0
LAB North,Nicaragua,2024,CSD,Pepsi,Pull-Non-Working,All Other Non-Working,Non-allocated NW,0,0,0,0,0,0,0
LAB North,Nicaragua,2024,CSD,Pepsi,Pull-Non-Working,All Other Non-Working,Other Non Working-non itemised talent,0,0,0,0,0,0,0
LAB North,Nicaragua,2024,CSD,Pepsi,Pull-Non-Working,All Other Non-Working,PR out of pocket administrative,0,0,0,0,0,0,0
LAB North,Nicaragua,2024,CSD,Pepsi,Pull-Non-Working,Innovation and Insight,Innovations,0,0,0,0,0,0,0
LAB North,Nicaragua,2024,CSD,Pepsi,Pull-Non-Working,Innovation and Insight,Market Research,50,99599,50689,48910,2728,1388,1340
LAB North,Nicaragua,2024,CSD,Pepsi,Pull-Non-Working,Package Design,Package design,0,0,0,0,0,0,0
LAB North,Nicaragua,2024,CSD,Pepsi,Pull-Non-Working,Package Design,Package development,0,0,0,0,0,0,0
LAB North,Nicaragua,2024,CSD,Pepsi,STB - Push,Capability Building/Other,Capability Building Other,0,0,0,0,0,0,0
LAB North,Nicaragua,2024,CSD,Pepsi,STB - Push,Other Investments,CDA's,50,3453633,1664060,1789573,94626,45593,49033
LAB North,Nicaragua,2024,CSD,Pepsi,STB - Push,Other Investments,Capital (Coolers),0,0,0,0,0,0,0
LAB North,Nicaragua,2024,CSD,Pepsi,STB - Push,Other Investments,Price Support,50,100213,50758,49455,2745,1390,1355
LAB North,Nicaragua,2024,CSD,Pepsi,STB - Push,Other Investments,Vending / Racks,0,0,0,0,0,0,0
LAB North,Nicaragua,2024,CSD,Pepsi,STB - Push,Other Trade,Frozen Funds,0,0,0,0,0,0,0
LAB North,Nicaragua,2024,CSD,Pepsi,STB - Push,Other Trade,Other Trade,0,0,0,0,0,0,0
LAB North,Nicaragua,2024,CSD,Pepsi,STB - Push,Trade Equipment,Coolers - New,50,501584,248976,252608,13742,6821,6921
LAB North,Nicaragua,2024,CSD,Pepsi,STB - Push,Trade Equipment,Coolers - Refurbished,0,0,0,0,0,0,0
LAB North,Nicaragua,2024,CSD,Pepsi,STB - Push,Trade Equipment,Post Mix / Pre Mix Equip.,0,0,0,0,0,0,0
LAB North,Nicaragua,2024,CSD,Pepsi,STB - Push,Trade Equipment,Vending / Racks,50,38518,19330,19188,1055,529,526
LAB North,Nicaragua,2024,CSD,Pepsi,STB - Push,Trade Programs,Distribution Incentives,0,0,0,0,0,0,0
LAB North,Nicaragua,2024,CSD,Pepsi,STB - Push,Trade Programs,Innovation Investments,0,0,0,0,0,0,0
LAB North,Nicaragua,2024,CSD,Pepsi,STB - Push,Trade Programs,Sales Incentives,0,0,0,0,0,0,0
LAB North,Nicaragua,2024,CSD,Pepsi,STB - Push,Trade Programs,Space Investments,0,0,0,0,0,0,0
LAB North,Nicaragua,2024,CSD,Pepsi,Pull-Working,All Other Working,Other Working - PR execution,50,386421,187793,198628,10587,5145,5442
LAB North,Nicaragua,2024,CSD,Pepsi,Pull-Working,All Other Working,Other Working - activation,0,0,0,0,0,0,0
LAB North,Nicaragua,2024,CSD,Pepsi,Pull-Working,All Other Working,Other Working - non allocated working,0,0,0,0,0,0,0
LAB North,Nicaragua,2024,CSD,Pepsi,Pull-Working,Consumer Promotions,Consumer Promotions Execution,0,0,0,0,0,0,0
LAB North,Nicaragua,2024,CSD,Pepsi,Pull-Working,Consumer Promotions,Coupons,0,0,0,0,0,0,0
LAB North,Nicaragua,2024,CSD,Pepsi,Pull-Working,Consumer Promotions,Other,0,0,0,0,0,0,0
LAB North,Nicaragua,2024,CSD,Pepsi,Pull-Working,Consumer Promotions,Premiums,50,168043,85655,82388,4604,2346,2258
LAB North,Nicaragua,2024,CSD,Pepsi,Pull-Working,In Store & POS Execution,In-Store & POS Execution,50,119712,59455,60257,3280,1629,1651
LAB North,Nicaragua,2024,CSD,Pepsi,Pull-Working,Media Placements,Cinema,0,0,0,0,0,0,0
LAB North,Nicaragua,2024,CSD,Pepsi,Pull-Working,Media Placements,Digital,50,57236,28651,28585,1568,785,783
LAB North,Nicaragua,2024,CSD,Pepsi,Pull-Working,Media Placements,OOH - Out Of Home,0,0,0,0,0,0,0
LAB North,Nicaragua,2024,CSD,Pepsi,Pull-Working,Media Placements,Other,0,0,0,0,0,0,0
LAB North,Nicaragua,2024,CSD,Pepsi,Pull-Working,Media Placements,Print,50,109754,56248,53506,3007,1541,1466
LAB North,Nicaragua,2024,CSD,Pepsi,Pull-Working,Media Placements,Radio,0,0,0,0,0,0,0
LAB North,Nicaragua,2024,CSD,Pepsi,Pull-Working,Media Placements,TV,0,0,0,0,0,0,0
LAB North,Nicaragua,2024,CSD,Pepsi,Pull-Working,Sampling,Product Samples,50,59496,28945,30551,1630,793,837
LAB North,Nicaragua,2024,CSD,Pepsi,Pull-Working,Sampling,Sampling Execution,0,0,0,0,0,0,0
LAB North,Nicaragua,2024,CSD,Pepsi,Pull-Working,Sponsorships,Sponsorships-in game/ in show,50,29433,14311,15122,806,392,414
LAB North,Nicaragua,2024,CSD,Pepsi,Pull-Working,Sponsorships,Sports-athlete/team contracts,0,0,0,0,0,0,0
LAB North,Nicaragua,2024,CSD,Pepsi,Pull-Working,Sponsorships,Sports-on field or in show props,0,0,0,0,0,0,0
LAB North,Nicaragua,2024,CSD,Pepsi,Pull-Working,Sponsorships,Sports-stadium contracts,0,0,0,0,0,0,0
LAB North,Puerto Rico,2024,Energy Drinks,AMP,Pull-Non-Working,Ad Production,Digital Ad Production,0,0,0,0,0,0,0
LAB North,Puerto Rico,2024,Energy Drinks,AMP,Pull-Non-Working,Ad Production,"TV, Print, Radio, OOH, Production",50,3908,1829,2079,3908,1829,2079
LAB North,Puerto Rico,2024,Energy Drinks,AMP,Pull-Non-Working,Agency Fees,Creative Agency Fees,0,0,0,0,0,0,0
LAB North,Puerto Rico,2024,Energy Drinks,AMP,Pull-Non-Working,Agency Fees,In Store & POS Design / Development,0,0,0,0,0,0,0
LAB North,Puerto Rico,2024,Energy Drinks,AMP,Pull-Non-Working,Agency Fees,Media Agency Fees,0,0,0,0,0,0,0
LAB North,Puerto Rico,2024,Energy Drinks,AMP,Pull-Non-Working,Agency Fees,Other,0,0,0,0,0,0,0
LAB North,Puerto Rico,2024,Energy Drinks,AMP,Pull-Non-Working,Agency Fees,Social Media / Influence Marketing,0,0,0,0,0,0,0
LAB North,Puerto Rico,2024,Energy Drinks,AMP,Pull-Non-Working,All Other Non-Working,Administrative fees,0,0,0,0,0,0,0
LAB North,Puerto Rico,2024,Energy Drinks,AMP,Pull-Non-Working,All Other Non-Working,Agency out of pocket,0,0,0,0,0,0,0
LAB North,Puerto Rico,2024,Energy Drinks,AMP,Pull-Non-Working,All Other Non-Working,CP out of pocket admin,0,0,0,0,0,0,0
LAB North,Puerto Rico,2024,Energy Drinks,AMP,Pull-Non-Working,All Other Non-Working,Grassroots/experiential out of pocket,0,0,0,0,0,0,0
LAB North,Puerto Rico,2024,Energy Drinks,AMP,Pull-Non-Working,All Other Non-Working,League/property- rights fee/options,0,0,0,0,0,0,0
LAB North,Puerto Rico,2024,Energy Drinks,AMP,Pull-Non-Working,All Other Non-Working,Market Research,0,0,0,0,0,0,0
LAB North,Puerto Rico,2024,Energy Drinks,AMP,Pull-Non-Working,All Other Non-Working,Non-allocated NW,0,0,0,0,0,0,0
LAB North,Puerto Rico,2024,Energy Drinks,AMP,Pull-Non-Working,All Other Non-Working,Other Non Working-non itemised talent,0,0,0,0,0,0,0
LAB North,Puerto Rico,2024,Energy Drinks,AMP,Pull-Non-Working,All Other Non-Working,PR out of pocket administrative,0,0,0,0,0,0,0
LAB North,Puerto Rico,2024,Energy Drinks,AMP,Pull-Non-Working,Innovation and Insight,Innovations,0,0,0,0,0,0,0
LAB North,Puerto Rico,2024,Energy Drinks,AMP,Pull-Non-Working,Innovation and Insight,Market Research,0,0,0,0,0,0,0
LAB North,Puerto Rico,2024,Energy Drinks,AMP,Pull-Non-Working,Package Design,Package design,0,0,0,0,0,0,0
LAB North,Puerto Rico,2024,Energy Drinks,AMP,Pull-Non-Working,Package Design,Package development,0,0,0,0,0,0,0
LAB North,Puerto Rico,2024,Energy Drinks,AMP,STB - Push,Capability Building/Other,Capability Building Other,0,0,0,0,0,0,0
LAB North,Puerto Rico,2024,Energy Drinks,AMP,STB - Push,Other Investments,CDA's,0,0,0,0,0,0,0
LAB North,Puerto Rico,2024,Energy Drinks,AMP,STB - Push,Other Investments,Capital (Coolers),0,0,0,0,0,0,0
LAB North,Puerto Rico,2024,Energy Drinks,AMP,STB - Push,Other Investments,Price Support,50,5716,2884,2832,5716,2884,2832
LAB North,Puerto Rico,2024,Energy Drinks,AMP,STB - Push,Other Investments,Vending / Racks,0,0,0,0,0,0,0
LAB North,Puerto Rico,2024,Energy Drinks,AMP,STB - Push,Other Trade,Frozen Funds,0,0,0,0,0,0,0
LAB North,Puerto Rico,2024,Energy Drinks,AMP,STB - Push,Other Trade,Other Trade,0,0,0,0,0,0,0
LAB North,Puerto Rico,2024,Energy Drinks,AMP,STB - Push,Trade Equipment,Coolers - New,0,0,0,0,0,0,0
LAB North,Puerto Rico,2024,Energy Drinks,AMP,STB - Push,Trade Equipment,Coolers - Refurbished,0,0,0,0,0,0,0
LAB North,Puerto Rico,2024,Energy Drinks,AMP,STB - Push,Trade Equipment,Post Mix / Pre Mix Equip.,0,0,0,0,0,0,0
LAB North,Puerto Rico,2024,Energy Drinks,AMP,STB - Push,Trade Equipment,Vending / Racks,0,0,0,0,0,0,0
LAB North,Puerto Rico,2024,Energy Drinks,AMP,STB - Push,Trade Programs,Distribution Incentives,0,0,0,0,0,0,0
LAB North,Puerto Rico,2024,Energy Drinks,AMP,STB - Push,Trade Programs,Innovation Investments,0,0,0,0,0,0,0
LAB North,Puerto Rico,2024,Energy Drinks,AMP,STB - Push,Trade Programs,Sales Incentives,50,21925,10827,11098,21925,10827,11098
LAB North,Puerto Rico,2024,Energy Drinks,AMP,STB - Push,Trade Programs,Space Investments,0,0,0,0,0,0,0
LAB North,Puerto Rico,2024,Energy Drinks,AMP,Pull-Working,All Other Working,Other Working - PR execution,50,4407,2245,2162,4407,2245,2162
LAB North,Puerto Rico,2024,Energy Drinks,AMP,Pull-Working,All Other Working,Other Working - activation,0,0,0,0,0,0,0
LAB North,Puerto Rico,2024,Energy Drinks,AMP,Pull-Working,All Other Working,Other Working - non allocated working,0,0,0,0,0,0,0
LAB North,Puerto Rico,2024,Energy Drinks,AMP,Pull-Working,Consumer Promotions,Consumer Promotions Execution,0,0,0,0,0,0,0
LAB North,Puerto Rico,2024,Energy Drinks,AMP,Pull-Working,Consumer Promotions,Coupons,0,0,0,0,0,0,0
LAB North,Puerto Rico,2024,Energy Drinks,AMP,Pull-Working,Consumer Promotions,Other,0,0,0,0,0,0,0
LAB North,Puerto Rico,2024,Energy Drinks,AMP,Pull-Working,Consumer Promotions,Premiums,50,2066,1097,969,2066,1097,969
LAB North,Puerto Rico,2024,Energy Drinks,AMP,Pull-Working,In Store & POS Execution,In-Store & POS Execution,50,3002,1493,1509,3002,1493,1509
LAB North,Puerto Rico,2024,Energy Drinks,AMP,Pull-Working,Media Placements,Cinema,0,0,0,0,0,0,0
LAB North,Puerto Rico,2024,Energy Drinks,AMP,Pull-Working,Media Placements,Digital,50,46936,23381,23555,46936,23381,23555
LAB North,Puerto Rico,2024,Energy Drinks,AMP,Pull-Working,Media Placements,OOH - Out Of Home,50,21191,10546,10645,21191,10546,10645
LAB North,Puerto Rico,2024,Energy Drinks,AMP,Pull-Working,Media Placements,Other,0,0,0,0,0,0,0
LAB North,Puerto Rico,2024,Energy Drinks,AMP,Pull-Working,Media Placements,Print,0,0,0,0,0,0,0
LAB North,Puerto Rico,2024,Energy Drinks,AMP,Pull-Working,Media Placements,Radio,50,3353,1696,1657,3353,1696,1657
LAB North,Puerto Rico,2024,Energy Drinks,AMP,Pull-Working,Media Placements,TV,50,6771,3448,3323,6771,3448,3323
LAB North,Puerto Rico,2024,Energy Drinks,AMP,Pull-Working,Sampling,Product Samples,0,0,0,0,0,0,0
LAB North,Puerto Rico,2024,Energy Drinks,AMP,Pull-Working,Sampling,Sampling Execution,0,0,0,0,0,0,0
LAB North,Puerto Rico,2024,Energy Drinks,AMP,Pull-Working,Sponsorships,Sponsorships-in game/ in show,50,1637,804,833,1637,804,833
LAB North,Puerto Rico,2024,Energy Drinks,AMP,Pull-Working,Sponsorships,Sports-athlete/team contracts,0,0,0,0,0,0,0
LAB North,Puerto Rico,2024,Energy Drinks,AMP,Pull-Working,Sponsorships,Sports-on field or in show props,0,0,0,0,0,0,0
LAB North,Puerto Rico,2024,Energy Drinks,AMP,Pull-Working,Sponsorships,Sports-stadium contracts,0,0,0,0,0,0,0
LAB North,Puerto Rico,2024,Energy Drinks,Adrenaline,Pull-Non-Working,Ad Production,Digital Ad Production,0,0,0,0,0,0,0
LAB North,Puerto Rico,2024,Energy Drinks,Adrenaline,Pull-Non-Working,Ad Production,"TV, Print, Radio, OOH, Production",0,0,0,0,0,0,0
LAB North,Puerto Rico,2024,Energy Drinks,Adrenaline,Pull-Non-Working,Agency Fees,Creative Agency Fees,0,0,0,0,0,0,0
LAB North,Puerto Rico,2024,Energy Drinks,Adrenaline,Pull-Non-Working,Agency Fees,In Store & POS Design / Development,0,0,0,0,0,0,0
LAB North,Puerto Rico,2024,Energy Drinks,Adrenaline,Pull-Non-Working,Agency Fees,Media Agency Fees,0,0,0,0,0,0,0
LAB North,Puerto Rico,2024,Energy Drinks,Adrenaline,Pull-Non-Working,Agency Fees,Other,0,0,0,0,0,0,0
LAB North,Puerto Rico,2024,Energy Drinks,Adrenaline,Pull-Non-Working,Agency Fees,Social Media / Influence Marketing,0,0,0,0,0,0,0
LAB North,Puerto Rico,2024,Energy Drinks,Adrenaline,Pull-Non-Working,All Other Non-Working,Administrative fees,0,0,0,0,0,0,0
LAB North,Puerto Rico,2024,Energy Drinks,Adrenaline,Pull-Non-Working,All Other Non-Working,Agency out of pocket,0,0,0,0,0,0,0
LAB North,Puerto Rico,2024,Energy Drinks,Adrenaline,Pull-Non-Working,All Other Non-Working,CP out of pocket admin,0,0,0,0,0,0,0
LAB North,Puerto Rico,2024,Energy Drinks,Adrenaline,Pull-Non-Working,All Other Non-Working,Grassroots/experiential out of pocket,0,0,0,0,0,0,0
LAB North,Puerto Rico,2024,Energy Drinks,Adrenaline,Pull-Non-Working,All Other Non-Working,League/property- rights fee/options,0,0,0,0,0,0,0
LAB North,Puerto Rico,2024,Energy Drinks,Adrenaline,Pull-Non-Working,All Other Non-Working,Market Research,0,0,0,0,0,0,0
LAB North,Puerto Rico,2024,Energy Drinks,Adrenaline,Pull-Non-Working,All Other Non-Working,Non-allocated NW,0,0,0,0,0,0,0
LAB North,Puerto Rico,2024,Energy Drinks,Adrenaline,Pull-Non-Working,All Other Non-Working,Other Non Working-non itemised talent,0,0,0,0,0,0,0
LAB North,Puerto Rico,2024,Energy Drinks,Adrenaline,Pull-Non-Working,All Other Non-Working,PR out of pocket administrative,0,0,0,0,0,0,0
LAB North,Puerto Rico,2024,Energy Drinks,Adrenaline,Pull-Non-Working,Innovation and Insight,Innovations,0,0,0,0,0,0,0
LAB North,Puerto Rico,2024,Energy Drinks,Adrenaline,Pull-Non-Working,Innovation and Insight,Market Research,0,0,0,0,0,0,0
LAB North,Puerto Rico,2024,Energy Drinks,Adrenaline,Pull-Non-Working,Package Design,Package design,0,0,0,0,0,0,0
LAB North,Puerto Rico,2024,Energy Drinks,Adrenaline,Pull-Non-Working,Package Design,Package development,0,0,0,0,0,0,0
LAB North,Puerto Rico,2024,Energy Drinks,Adrenaline,STB - Push,Capability Building/Other,Capability Building Other,0,0,0,0,0,0,0
LAB North,Puerto Rico,2024,Energy Drinks,Adrenaline,STB - Push,Other Investments,CDA's,0,0,0,0,0,0,0
LAB North,Puerto Rico,2024,Energy Drinks,Adrenaline,STB - Push,Other Investments,Capital (Coolers),0,0,0,0,0,0,0
LAB North,Puerto Rico,2024,Energy Drinks,Adrenaline,STB - Push,Other Investments,Price Support,50,3124,1574,1550,3124,1574,1550
LAB North,Puerto Rico,2024,Energy Drinks,Adrenaline,STB - Push,Other Investments,Vending / Racks,0,0,0,0,0,0,0
LAB North,Puerto Rico,2024,Energy Drinks,Adrenaline,STB - Push,Other Trade,Frozen Funds,0,0,0,0,0,0,0
LAB North,Puerto Rico,2024,Energy Drinks,Adrenaline,STB - Push,Other Trade,Other Trade,0,0,0,0,0,0,0
LAB North,Puerto Rico,2024,Energy Drinks,Adrenaline,STB - Push,Trade Equipment,Coolers - New,0,0,0,0,0,0,0
LAB North,Puerto Rico,2024,Energy Drinks,Adrenaline,STB - Push,Trade Equipment,Coolers - Refurbished,0,0,0,0,0,0,0
LAB North,Puerto Rico,2024,Energy Drinks,Adrenaline,STB - Push,Trade Equipment,Post Mix / Pre Mix Equip.,0,0,0,0,0,0,0
LAB North,Puerto Rico,2024,Energy Drinks,Adrenaline,STB - Push,Trade Equipment,Vending / Racks,0,0,0,0,0,0,0
LAB North,Puerto Rico,2024,Energy Drinks,Adrenaline,STB - Push,Trade Programs,Distribution Incentives,0,0,0,0,0,0,0
LAB North,Puerto Rico,2024,Energy Drinks,Adrenaline,STB - Push,Trade Programs,Innovation Investments,0,0,0,0,0,0,0
LAB North,Puerto Rico,2024,Energy Drinks,Adrenaline,STB - Push,Trade Programs,Sales Incentives,0,0,0,0,0,0,0
LAB North,Puerto Rico,2024,Energy Drinks,Adrenaline,STB - Push,Trade Programs,Space Investments,0,0,0,0,0,0,0
LAB North,Puerto Rico,2024,Energy Drinks,Adrenaline,Pull-Working,All Other Working,Other Working - PR execution,0,0,0,0,0,0,0
LAB North,Puerto Rico,2024,Energy Drinks,Adrenaline,Pull-Working,All Other Working,Other Working - activation,0,0,0,0,0,0,0
LAB North,Puerto Rico,2024,Energy Drinks,Adrenaline,Pull-Working,All Other Working,Other Working - non allocated working,0,0,0,0,0,0,0
LAB North,Puerto Rico,2024,Energy Drinks,Adrenaline,Pull-Working,Consumer Promotions,Consumer Promotions Execution,0,0,0,0,0,0,0
LAB North,Puerto Rico,2024,Energy Drinks,Adrenaline,Pull-Working,Consumer Promotions,Coupons,0,0,0,0,0,0,0
LAB North,Puerto Rico,2024,Energy Drinks,Adrenaline,Pull-Working,Consumer Promotions,Other,0,0,0,0,0,0,0
LAB North,Puerto Rico,2024,Energy Drinks,Adrenaline,Pull-Working,Consumer Promotions,Premiums,0,0,0,0,0,0,0
LAB North,Puerto Rico,2024,Energy Drinks,Adrenaline,Pull-Working,In Store & POS Execution,In-Store & POS Execution,50,2290,1164,1126,2290,1164,1126
LAB North,Puerto Rico,2024,Energy Drinks,Adrenaline,Pull-Working,Media Placements,Cinema,0,0,0,0,0,0,0
LAB North,Puerto Rico,2024,Energy Drinks,Adrenaline,Pull-Working,Media Placements,Digital,0,0,0,0,0,0,0
LAB North,Puerto Rico,2024,Energy Drinks,Adrenaline,Pull-Working,Media Placements,OOH - Out Of Home,0,0,0,0,0,0,0
LAB North,Puerto Rico,2024,Energy Drinks,Adrenaline,Pull-Working,Media Placements,Other,0,0,0,0,0,0,0
LAB North,Puerto Rico,2024,Energy Drinks,Adrenaline,Pull-Working,Media Placements,Print,0,0,0,0,0,0,0
LAB North,Puerto Rico,2024,Energy Drinks,Adrenaline,Pull-Working,Media Placements,Radio,0,0,0,0,0,0,0
LAB North,Puerto Rico,2024,Energy Drinks,Adrenaline,Pull-Working,Media Placements,TV,0,0,0,0,0,0,0
LAB North,Puerto Rico,2024,Energy Drinks,Adrenaline,Pull-Working,Sampling,Product Samples,0,0,0,0,0,0,0
LAB North,Puerto Rico,2024,Energy Drinks,Adrenaline,Pull-Working,Sampling,Sampling Execution,0,0,0,0,0,0,0
LAB North,Puerto Rico,2024,Energy Drinks,Adrenaline,Pull-Working,Sponsorships,Sponsorships-in game/ in show,0,0,0,0,0,0,0
LAB North,Puerto Rico,2024,Energy Drinks,Adrenaline,Pull-Working,Sponsorships,Sports-athlete/team contracts,0,0,0,0,0,0,0
LAB North,Puerto Rico,2024,Energy Drinks,Adrenaline,Pull-Working,Sponsorships,Sports-on field or in show props,0,0,0,0,0,0,0
LAB North,Puerto Rico,2024,Energy Drinks,Adrenaline,Pull-Working,Sponsorships,Sports-stadium contracts,0,0,0,0,0,0,0
LAB North,Puerto Rico,2024,Water,Be-Light,Pull-Non-Working,Ad Production,Digital Ad Production,0,0,0,0,0,0,0
LAB North,Puerto Rico,2024,Water,Be-Light,Pull-Non-Working,Ad Production,"TV, Print, Radio, OOH, Production",0,0,0,0,0,0,0
LAB North,Puerto Rico,2024,Water,Be-Light,Pull-Non-Working,Agency Fees,Creative Agency Fees,0,0,0,0,0,0,0
LAB North,Puerto Rico,2024,Water,Be-Light,Pull-Non-Working,Agency Fees,In Store & POS Design / Development,0,0,0,0,0,0,0
LAB North,Puerto Rico,2024,Water,Be-Light,Pull-Non-Working,Agency Fees,Media Agency Fees,0,0,0,0,0,0,0
LAB North,Puerto Rico,2024,Water,Be-Light,Pull-Non-Working,Agency Fees,Other,0,0,0,0,0,0,0
LAB North,Puerto Rico,2024,Water,Be-Light,Pull-Non-Working,Agency Fees,Social Media / Influence Marketing,0,0,0,0,0,0,0
LAB North,Puerto Rico,2024,Water,Be-Light,Pull-Non-Working,All Other Non-Working,Administrative fees,0,0,0,0,0,0,0
LAB North,Puerto Rico,2024,Water,Be-Light,Pull-Non-Working,All Other Non-Working,Agency out of pocket,0,0,0,0,0,0,0
LAB North,Puerto Rico,2024,Water,Be-Light,Pull-Non-Working,All Other Non-Working,CP out of pocket admin,0,0,0,0,0,0,0
LAB North,Puerto Rico,2024,Water,Be-Light,Pull-Non-Working,All Other Non-Working,Grassroots/experiential out of pocket,0,0,0,0,0,0,0
LAB North,Puerto Rico,2024,Water,Be-Light,Pull-Non-Working,All Other Non-Working,League/property- rights fee/options,0,0,0,0,0,0,0
LAB North,Puerto Rico,2024,Water,Be-Light,Pull-Non-Working,All Other Non-Working,Market Research,0,0,0,0,0,0,0
LAB North,Puerto Rico,2024,Water,Be-Light,Pull-Non-Working,All Other Non-Working,Non-allocated NW,0,0,0,0,0,0,0
LAB North,Puerto Rico,2024,Water,Be-Light,Pull-Non-Working,All Other Non-Working,Other Non Working-non itemised talent,0,0,0,0,0,0,0
LAB North,Puerto Rico,2024,Water,Be-Light,Pull-Non-Working,All Other Non-Working,PR out of pocket administrative,0,0,0,0,0,0,0
LAB North,Puerto Rico,2024,Water,Be-Light,Pull-Non-Working,Innovation and Insight,Innovations,0,0,0,0,0,0,0
LAB North,Puerto Rico,2024,Water,Be-Light,Pull-Non-Working,Innovation and Insight,Market Research,0,0,0,0,0,0,0
LAB North,Puerto Rico,2024,Water,Be-Light,Pull-Non-Working,Package Design,Package design,0,0,0,0,0,0,0
LAB North,Puerto Rico,2024,Water,Be-Light,Pull-Non-Working,Package Design,Package development,0,0,0,0,0,0,0
LAB North,Puerto Rico,2024,Water,Be-Light,STB - Push,Capability Building/Other,Capability Building Other,0,0,0,0,0,0,0
LAB North,Puerto Rico,2024,Water,Be-Light,STB - Push,Other Investments,CDA's,0,0,0,0,0,0,0
LAB North,Puerto Rico,2024,Water,Be-Light,STB - Push,Other Investments,Capital (Coolers),0,0,0,0,0,0,0
LAB North,Puerto Rico,2024,Water,Be-Light,STB - Push,Other Investments,Price Support,50,87,43,44,87,43,44
LAB North,Puerto Rico,2024,Water,Be-Light,STB - Push,Other Investments,Vending / Racks,0,0,0,0,0,0,0
LAB North,Puerto Rico,2024,Water,Be-Light,STB - Push,Other Trade,Frozen Funds,0,0,0,0,0,0,0
LAB North,Puerto Rico,2024,Water,Be-Light,STB - Push,Other Trade,Other Trade,0,0,0,0,0,0,0
LAB North,Puerto Rico,2024,Water,Be-Light,STB - Push,Trade Equipment,Coolers - New,0,0,0,0,0,0,0
LAB North,Puerto Rico,2024,Water,Be-Light,STB - Push,Trade Equipment,Coolers - Refurbished,0,0,0,0,0,0,0
LAB North,Puerto Rico,2024,Water,Be-Light,STB - Push,Trade Equipment,Post Mix / Pre Mix Equip.,0,0,0,0,0,0,0
LAB North,Puerto Rico,2024,Water,Be-Light,STB - Push,Trade Equipment,Vending / Racks,0,0,0,0,0,0,0
LAB North,Puerto Rico,2024,Water,Be-Light,STB - Push,Trade Programs,Distribution Incentives,0,0,0,0,0,0,0
LAB North,Puerto Rico,2024,Water,Be-Light,STB - Push,Trade Programs,Innovation Investments,0,0,0,0,0,0,0
LAB North,Puerto Rico,2024,Water,Be-Light,STB - Push,Trade Programs,Sales Incentives,0,0,0,0,0,0,0
LAB North,Puerto Rico,2024,Water,Be-Light,STB - Push,Trade Programs,Space Investments,0,0,0,0,0,0,0
LAB North,Puerto Rico,2024,Water,Be-Light,Pull-Working,All Other Working,Other Working - PR execution,0,0,0,0,0,0,0
LAB North,Puerto Rico,2024,Water,Be-Light,Pull-Working,All Other Working,Other Working - activation,0,0,0,0,0,0,0
LAB North,Puerto Rico,2024,Water,Be-Light,Pull-Working,All Other Working,Other Working - non allocated working,0,0,0,0,0,0,0
LAB North,Puerto Rico,2024,Water,Be-Light,Pull-Working,Consumer Promotions,Consumer Promotions Execution,0,0,0,0,0,0,0
LAB North,Puerto Rico,2024,Water,Be-Light,Pull-Working,Consumer Promotions,Coupons,0,0,0,0,0,0,0
LAB North,Puerto Rico,2024,Water,Be-Light,Pull-Working,Consumer Promotions,Other,0,0,0,0,0,0,0
LAB North,Puerto Rico,2024,Water,Be-Light,Pull-Working,Consumer Promotions,Premiums,0,0,0,0,0,0,0
LAB North,Puerto Rico,2024,Water,Be-Light,Pull-Working,In Store & POS Execution,In-Store & POS Execution,0,0,0,0,0,0,0
LAB North,Puerto Rico,2024,Water,Be-Light,Pull-Working,Media Placements,Cinema,0,0,0,0,0,0,0
LAB North,Puerto Rico,2024,Water,Be-Light,Pull-Working,Media Placements,Digital,0,0,0,0,0,0,0
LAB North,Puerto Rico,2024,Water,Be-Light,Pull-Working,Media Placements,OOH - Out Of Home,0,0,0,0,0,0,0
LAB North,Puerto Rico,2024,Water,Be-Light,Pull-Working,Media Placements,Other,0,0,0,0,0,0,0
LAB North,Puerto Rico,2024,Water,Be-Light,Pull-Working,Media Placements,Print,0,0,0,0,0,0,0
LAB North,Puerto Rico,2024,Water,Be-Light,Pull-Working,Media Placements,Radio,0,0,0,0,0,0,0
LAB North,Puerto Rico,2024,Water,Be-Light,Pull-Working,Media Placements,TV,0,0,0,0,0,0,0
LAB North,Puerto Rico,2024,Water,Be-Light,Pull-Working,Sampling,Product Samples,0,0,0,0,0,0,0
LAB North,Puerto Rico,2024,Water,Be-Light,Pull-Working,Sampling,Sampling Execution,0,0,0,0,0,0,0
LAB North,Puerto Rico,2024,Water,Be-Light,Pull-Working,Sponsorships,Sponsorships-in game/ in show,0,0,0,0,0,0,0
LAB North,Puerto Rico,2024,Water,Be-Light,Pull-Working,Sponsorships,Sports-athlete/team contracts,0,0,0,0,0,0,0
LAB North,Puerto Rico,2024,Water,Be-Light,Pull-Working,Sponsorships,Sports-on field or in show props,0,0,0,0,0,0,0
LAB North,Puerto Rico,2024,Water,Be-Light,Pull-Working,Sponsorships,Sports-stadium contracts,0,0,0,0,0,0,0
LAB North,Puerto Rico,2024,Sport Drinks,Gatorade,Pull-Non-Working,Ad Production,Digital Ad Production,0,0,0,0,0,0,0
LAB North,Puerto Rico,2024,Sport Drinks,Gatorade,Pull-Non-Working,Ad Production,"TV, Print, Radio, OOH, Production",50,59849,29884,29965,59849,29884,29965
LAB North,Puerto Rico,2024,Sport Drinks,Gatorade,Pull-Non-Working,Agency Fees,Creative Agency Fees,0,0,0,0,0,0,0
LAB North,Puerto Rico,2024,Sport Drinks,Gatorade,Pull-Non-Working,Agency Fees,In Store & POS Design / Development,0,0,0,0,0,0,0
LAB North,Puerto Rico,2024,Sport Drinks,Gatorade,Pull-Non-Working,Agency Fees,Media Agency Fees,0,0,0,0,0,0,0
LAB North,Puerto Rico,2024,Sport Drinks,Gatorade,Pull-Non-Working,Agency Fees,Other,0,0,0,0,0,0,0
LAB North,Puerto Rico,2024,Sport Drinks,Gatorade,Pull-Non-Working,Agency Fees,Social Media / Influence Marketing,0,0,0,0,0,0,0
LAB North,Puerto Rico,2024,Sport Drinks,Gatorade,Pull-Non-Working,All Other Non-Working,Administrative fees,0,0,0,0,0,0,0
LAB North,Puerto Rico,2024,Sport Drinks,Gatorade,Pull-Non-Working,All Other Non-Working,Agency out of pocket,0,0,0,0,0,0,0
LAB North,Puerto Rico,2024,Sport Drinks,Gatorade,Pull-Non-Working,All Other Non-Working,CP out of pocket admin,0,0,0,0,0,0,0
LAB North,Puerto Rico,2024,Sport Drinks,Gatorade,Pull-Non-Working,All Other Non-Working,Grassroots/experiential out of pocket,0,0,0,0,0,0,0
LAB North,Puerto Rico,2024,Sport Drinks,Gatorade,Pull-Non-Working,All Other Non-Working,League/property- rights fee/options,0,0,0,0,0,0,0
LAB North,Puerto Rico,2024,Sport Drinks,Gatorade,Pull-Non-Working,All Other Non-Working,Market Research,0,0,0,0,0,0,0
LAB North,Puerto Rico,2024,Sport Drinks,Gatorade,Pull-Non-Working,All Other Non-Working,Non-allocated NW,0,0,0,0,0,0,0
LAB North,Puerto Rico,2024,Sport Drinks,Gatorade,Pull-Non-Working,All Other Non-Working,Other Non Working-non itemised talent,0,0,0,0,0,0,0
LAB North,Puerto Rico,2024,Sport Drinks,Gatorade,Pull-Non-Working,All Other Non-Working,PR out of pocket administrative,0,0,0,0,0,0,0
LAB North,Puerto Rico,2024,Sport Drinks,Gatorade,Pull-Non-Working,Innovation and Insight,Innovations,0,0,0,0,0,0,0
LAB North,Puerto Rico,2024,Sport Drinks,Gatorade,Pull-Non-Working,Innovation and Insight,Market Research,0,0,0,0,0,0,0
LAB North,Puerto Rico,2024,Sport Drinks,Gatorade,Pull-Non-Working,Package Design,Package design,0,0,0,0,0,0,0
LAB North,Puerto Rico,2024,Sport Drinks,Gatorade,Pull-Non-Working,Package Design,Package development,0,0,0,0,0,0,0
LAB North,Puerto Rico,2024,Sport Drinks,Gatorade,STB - Push,Capability Building/Other,Capability Building Other,0,0,0,0,0,0,0
LAB North,Puerto Rico,2024,Sport Drinks,Gatorade,STB - Push,Other Investments,CDA's,0,0,0,0,0,0,0
LAB North,Puerto Rico,2024,Sport Drinks,Gatorade,STB - Push,Other Investments,Capital (Coolers),0,0,0,0,0,0,0
LAB North,Puerto Rico,2024,Sport Drinks,Gatorade,STB - Push,Other Investments,Price Support,50,1035509,529560,505949,1035509,529560,505949
LAB North,Puerto Rico,2024,Sport Drinks,Gatorade,STB - Push,Other Investments,Vending / Racks,0,0,0,0,0,0,0
LAB North,Puerto Rico,2024,Sport Drinks,Gatorade,STB - Push,Other Trade,Frozen Funds,0,0,0,0,0,0,0
LAB North,Puerto Rico,2024,Sport Drinks,Gatorade,STB - Push,Other Trade,Other Trade,0,0,0,0,0,0,0
LAB North,Puerto Rico,2024,Sport Drinks,Gatorade,STB - Push,Trade Equipment,Coolers - New,0,0,0,0,0,0,0
LAB North,Puerto Rico,2024,Sport Drinks,Gatorade,STB - Push,Trade Equipment,Coolers - Refurbished,0,0,0,0,0,0,0
LAB North,Puerto Rico,2024,Sport Drinks,Gatorade,STB - Push,Trade Equipment,Post Mix / Pre Mix Equip.,0,0,0,0,0,0,0
LAB North,Puerto Rico,2024,Sport Drinks,Gatorade,STB - Push,Trade Equipment,Vending / Racks,0,0,0,0,0,0,0
LAB North,Puerto Rico,2024,Sport Drinks,Gatorade,STB - Push,Trade Programs,Distribution Incentives,0,0,0,0,0,0,0
LAB North,Puerto Rico,2024,Sport Drinks,Gatorade,STB - Push,Trade Programs,Innovation Investments,0,0,0,0,0,0,0
LAB North,Puerto Rico,2024,Sport Drinks,Gatorade,STB - Push,Trade Programs,Sales Incentives,50,58404,28849,29555,58404,28849,29555
LAB North,Puerto Rico,2024,Sport Drinks,Gatorade,STB - Push,Trade Programs,Space Investments,0,0,0,0,0,0,0
LAB North,Puerto Rico,2024,Sport Drinks,Gatorade,Pull-Working,All Other Working,Other Working - PR execution,50,11832,5830,6002,11832,5830,6002
LAB North,Puerto Rico,2024,Sport Drinks,Gatorade,Pull-Working,All Other Working,Other Working - activation,0,0,0,0,0,0,0
LAB North,Puerto Rico,2024,Sport Drinks,Gatorade,Pull-Working,All Other Working,Other Working - non allocated working,0,0,0,0,0,0,0
LAB North,Puerto Rico,2024,Sport Drinks,Gatorade,Pull-Working,Consumer Promotions,Consumer Promotions Execution,0,0,0,0,0,0,0
LAB North,Puerto Rico,2024,Sport Drinks,Gatorade,Pull-Working,Consumer Promotions,Coupons,0,0,0,0,0,0,0
LAB North,Puerto Rico,2024,Sport Drinks,Gatorade,Pull-Working,Consumer Promotions,Other,0,0,0,0,0,0,0
LAB North,Puerto Rico,2024,Sport Drinks,Gatorade,Pull-Working,Consumer Promotions,Premiums,50,67949,33455,34494,67949,33455,34494
LAB North,Puerto Rico,2024,Sport Drinks,Gatorade,Pull-Working,In Store & POS Execution,In-Store & POS Execution,50,70357,33711,36646,70357,33711,36646
LAB North,Puerto Rico,2024,Sport Drinks,Gatorade,Pull-Working,Media Placements,Cinema,0,0,0,0,0,0,0
LAB North,Puerto Rico,2024,Sport Drinks,Gatorade,Pull-Working,Media Placements,Digital,50,101729,49754,51975,101729,49754,51975
LAB North,Puerto Rico,2024,Sport Drinks,Gatorade,Pull-Working,Media Placements,OOH - Out Of Home,50,104017,53171,50846,104017,53171,50846
LAB North,Puerto Rico,2024,Sport Drinks,Gatorade,Pull-Working,Media Placements,Other,0,0,0,0,0,0,0
LAB North,Puerto Rico,2024,Sport Drinks,Gatorade,Pull-Working,Media Placements,Print,0,0,0,0,0,0,0
LAB North,Puerto Rico,2024,Sport Drinks,Gatorade,Pull-Working,Media Placements,Radio,50,7273,3659,3614,7273,3659,3614
LAB North,Puerto Rico,2024,Sport Drinks,Gatorade,Pull-Working,Media Placements,TV,50,23023,11184,11839,23023,11184,11839
LAB North,Puerto Rico,2024,Sport Drinks,Gatorade,Pull-Working,Sampling,Product Samples,0,0,0,0,0,0,0
LAB North,Puerto Rico,2024,Sport Drinks,Gatorade,Pull-Working,Sampling,Sampling Execution,0,0,0,0,0,0,0
LAB North,Puerto Rico,2024,Sport Drinks,Gatorade,Pull-Working,Sponsorships,Sponsorships-in game/ in show,50,82572,43610,38962,82572,43610,38962
LAB North,Puerto Rico,2024,Sport Drinks,Gatorade,Pull-Working,Sponsorships,Sports-athlete/team contracts,50,90818,43904,46914,90818,43904,46914
LAB North,Puerto Rico,2024,Sport Drinks,Gatorade,Pull-Working,Sponsorships,Sports-on field or in show props,0,0,0,0,0,0,0
LAB North,Puerto Rico,2024,Sport Drinks,Gatorade,Pull-Working,Sponsorships,Sports-stadium contracts,0,0,0,0,0,0,0
LAB North,Puerto Rico,2024,RTD Tea,Lipton,Pull-Non-Working,Ad Production,Digital Ad Production,0,0,0,0,0,0,0
LAB North,Puerto Rico,2024,RTD Tea,Lipton,Pull-Non-Working,Ad Production,"TV, Print, Radio, OOH, Production",50,17108,8788,8320,17108,8788,8320
LAB North,Puerto Rico,2024,RTD Tea,Lipton,Pull-Non-Working,Agency Fees,Creative Agency Fees,0,0,0,0,0,0,0
LAB North,Puerto Rico,2024,RTD Tea,Lipton,Pull-Non-Working,Agency Fees,In Store & POS Design / Development,0,0,0,0,0,0,0
LAB North,Puerto Rico,2024,RTD Tea,Lipton,Pull-Non-Working,Agency Fees,Media Agency Fees,0,0,0,0,0,0,0
LAB North,Puerto Rico,2024,RTD Tea,Lipton,Pull-Non-Working,Agency Fees,Other,0,0,0,0,0,0,0
LAB North,Puerto Rico,2024,RTD Tea,Lipton,Pull-Non-Working,Agency Fees,Social Media / Influence Marketing,0,0,0,0,0,0,0
LAB North,Puerto Rico,2024,RTD Tea,Lipton,Pull-Non-Working,All Other Non-Working,Administrative fees,0,0,0,0,0,0,0
LAB North,Puerto Rico,2024,RTD Tea,Lipton,Pull-Non-Working,All Other Non-Working,Agency out of pocket,0,0,0,0,0,0,0
LAB North,Puerto Rico,2024,RTD Tea,Lipton,Pull-Non-Working,All Other Non-Working,CP out of pocket admin,0,0,0,0,0,0,0
LAB North,Puerto Rico,2024,RTD Tea,Lipton,Pull-Non-Working,All Other Non-Working,Grassroots/experiential out of pocket,0,0,0,0,0,0,0
LAB North,Puerto Rico,2024,RTD Tea,Lipton,Pull-Non-Working,All Other Non-Working,League/property- rights fee/options,0,0,0,0,0,0,0
LAB North,Puerto Rico,2024,RTD Tea,Lipton,Pull-Non-Working,All Other Non-Working,Market Research,0,0,0,0,0,0,0
LAB North,Puerto Rico,2024,RTD Tea,Lipton,Pull-Non-Working,All Other Non-Working,Non-allocated NW,0,0,0,0,0,0,0
LAB North,Puerto Rico,2024,RTD Tea,Lipton,Pull-Non-Working,All Other Non-Working,Other Non Working-non itemised talent,0,0,0,0,0,0,0
LAB North,Puerto Rico,2024,RTD Tea,Lipton,Pull-Non-Working,All Other Non-Working,PR out of pocket administrative,0,0,0,0,0,0,0
LAB North,Puerto Rico,2024,RTD Tea,Lipton,Pull-Non-Working,Innovation and Insight,Innovations,0,0,0,0,0,0,0
LAB North,Puerto Rico,2024,RTD Tea,Lipton,Pull-Non-Working,Innovation and Insight,Market Research,0,0,0,0,0,0,0
LAB North,Puerto Rico,2024,RTD Tea,Lipton,Pull-Non-Working,Package Design,Package design,0,0,0,0,0,0,0
LAB North,Puerto Rico,2024,RTD Tea,Lipton,Pull-Non-Working,Package Design,Package development,0,0,0,0,0,0,0
LAB North,Puerto Rico,2024,RTD Tea,Lipton,STB - Push,Capability Building/Other,Capability Building Other,0,0,0,0,0,0,0
LAB North,Puerto Rico,2024,RTD Tea,Lipton,STB - Push,Other Investments,CDA's,50,536225,251644,284581,536225,251644,284581
LAB North,Puerto Rico,2024,RTD Tea,Lipton,STB - Push,Other Investments,Capital (Coolers),0,0,0,0,0,0,0
LAB North,Puerto Rico,2024,RTD Tea,Lipton,STB - Push,Other Investments,Price Support,50,218754,108699,110055,218754,108699,110055
LAB North,Puerto Rico,2024,RTD Tea,Lipton,STB - Push,Other Investments,Vending / Racks,0,0,0,0,0,0,0
LAB North,Puerto Rico,2024,RTD Tea,Lipton,STB - Push,Other Trade,Frozen Funds,0,0,0,0,0,0,0
LAB North,Puerto Rico,2024,RTD Tea,Lipton,STB - Push,Other Trade,Other Trade,0,0,0,0,0,0,0
LAB North,Puerto Rico,2024,RTD Tea,Lipton,STB - Push,Trade Equipment,Coolers - New,0,0,0,0,0,0,0
LAB North,Puerto Rico,2024,RTD Tea,Lipton,STB - Push,Trade Equipment,Coolers - Refurbished,0,0,0,0,0,0,0
LAB North,Puerto Rico,2024,RTD Tea,Lipton,STB - Push,Trade Equipment,Post Mix / Pre Mix Equip.,50,357619,168968,188651,357619,168968,188651
LAB North,Puerto Rico,2024,RTD Tea,Lipton,STB - Push,Trade Equipment,Vending / Racks,0,0,0,0,0,0,0
LAB North,Puerto Rico,2024,RTD Tea,Lipton,STB - Push,Trade Programs,Distribution Incentives,0,0,0,0,0,0,0
LAB North,Puerto Rico,2024,RTD Tea,Lipton,STB - Push,Trade Programs,Innovation Investments,0,0,0,0,0,0,0
LAB North,Puerto Rico,2024,RTD Tea,Lipton,STB - Push,Trade Programs,Sales Incentives,50,1012,511,501,1012,511,501
LAB North,Puerto Rico,2024,RTD Tea,Lipton,STB - Push,Trade Programs,Space Investments,0,0,0,0,0,0,0
LAB North,Puerto Rico,2024,RTD Tea,Lipton,Pull-Working,All Other Working,Other Working - PR execution,50,4218,2192,2026,4218,2192,2026
LAB North,Puerto Rico,2024,RTD Tea,Lipton,Pull-Working,All Other Working,Other Working - activation,0,0,0,0,0,0,0
LAB North,Puerto Rico,2024,RTD Tea,Lipton,Pull-Working,All Other Working,Other Working - non allocated working,0,0,0,0,0,0,0
LAB North,Puerto Rico,2024,RTD Tea,Lipton,Pull-Working,Consumer Promotions,Consumer Promotions Execution,0,0,0,0,0,0,0
LAB North,Puerto Rico,2024,RTD Tea,Lipton,Pull-Working,Consumer Promotions,Coupons,0,0,0,0,0,0,0
LAB North,Puerto Rico,2024,RTD Tea,Lipton,Pull-Working,Consumer Promotions,Other,0,0,0,0,0,0,0
LAB North,Puerto Rico,2024,RTD Tea,Lipton,Pull-Working,Consumer Promotions,Premiums,50,20056,10047,10009,20056,10047,10009
LAB North,Puerto Rico,2024,RTD Tea,Lipton,Pull-Working,In Store & POS Execution,In-Store & POS Execution,50,15116,7982,7134,15116,7982,7134
LAB North,Puerto Rico,2024,RTD Tea,Lipton,Pull-Working,Media Placements,Cinema,0,0,0,0,0,0,0
LAB North,Puerto Rico,2024,RTD Tea,Lipton,Pull-Working,Media Placements,Digital,50,91297,44037,47260,91297,44037,47260
LAB North,Puerto Rico,2024,RTD Tea,Lipton,Pull-Working,Media Placements,OOH - Out Of Home,50,52743,26971,25772,52743,26971,25772
LAB North,Puerto Rico,2024,RTD Tea,Lipton,Pull-Working,Media Placements,Other,0,0,0,0,0,0,0
LAB North,Puerto Rico,2024,RTD Tea,Lipton,Pull-Working,Media Placements,Print,0,0,0,0,0,0,0
LAB North,Puerto Rico,2024,RTD Tea,Lipton,Pull-Working,Media Placements,Radio,0,0,0,0,0,0,0
LAB North,Puerto Rico,2024,RTD Tea,Lipton,Pull-Working,Media Placements,TV,0,0,0,0,0,0,0
LAB North,Puerto Rico,2024,RTD Tea,Lipton,Pull-Working,Sampling,Product Samples,0,0,0,0,0,0,0
LAB North,Puerto Rico,2024,RTD Tea,Lipton,Pull-Working,Sampling,Sampling Execution,0,0,0,0,0,0,0
LAB North,Puerto Rico,2024,RTD Tea,Lipton,Pull-Working,Sponsorships,Sponsorships-in game/ in show,50,28048,13920,14128,28048,13920,14128
LAB North,Puerto Rico,2024,RTD Tea,Lipton,Pull-Working,Sponsorships,Sports-athlete/team contracts,0,0,0,0,0,0,0
LAB North,Puerto Rico,2024,RTD Tea,Lipton,Pull-Working,Sponsorships,Sports-on field or in show props,0,0,0,0,0,0,0
LAB North,Puerto Rico,2024,RTD Tea,Lipton,Pull-Working,Sponsorships,Sports-stadium contracts,0,0,0,0,0,0,0
LAB North,Puerto Rico,2024,CSD,Pepsi,Pull-Non-Working,Ad Production,Digital Ad Production,0,0,0,0,0,0,0
LAB North,Puerto Rico,2024,CSD,Pepsi,Pull-Non-Working,Ad Production,"TV, Print, Radio, OOH, Production",50,75081,39301,35780,75081,39301,35780
LAB North,Puerto Rico,2024,CSD,Pepsi,Pull-Non-Working,Agency Fees,Creative Agency Fees,0,0,0,0,0,0,0
LAB North,Puerto Rico,2024,CSD,Pepsi,Pull-Non-Working,Agency Fees,In Store & POS Design / Development,0,0,0,0,0,0,0
LAB North,Puerto Rico,2024,CSD,Pepsi,Pull-Non-Working,Agency Fees,Media Agency Fees,0,0,0,0,0,0,0
LAB North,Puerto Rico,2024,CSD,Pepsi,Pull-Non-Working,Agency Fees,Other,0,0,0,0,0,0,0
LAB North,Puerto Rico,2024,CSD,Pepsi,Pull-Non-Working,Agency Fees,Social Media / Influence Marketing,0,0,0,0,0,0,0
LAB North,Puerto Rico,2024,CSD,Pepsi,Pull-Non-Working,All Other Non-Working,Administrative fees,0,0,0,0,0,0,0
LAB North,Puerto Rico,2024,CSD,Pepsi,Pull-Non-Working,All Other Non-Working,Agency out of pocket,0,0,0,0,0,0,0
LAB North,Puerto Rico,2024,CSD,Pepsi,Pull-Non-Working,All Other Non-Working,CP out of pocket admin,0,0,0,0,0,0,0
LAB North,Puerto Rico,2024,CSD,Pepsi,Pull-Non-Working,All Other Non-Working,Grassroots/experiential out of pocket,0,0,0,0,0,0,0
LAB North,Puerto Rico,2024,CSD,Pepsi,Pull-Non-Working,All Other Non-Working,League/property- rights fee/options,0,0,0,0,0,0,0
LAB North,Puerto Rico,2024,CSD,Pepsi,Pull-Non-Working,All Other Non-Working,Market Research,0,0,0,0,0,0,0
LAB North,Puerto Rico,2024,CSD,Pepsi,Pull-Non-Working,All Other Non-Working,Non-allocated NW,0,0,0,0,0,0,0
LAB North,Puerto Rico,2024,CSD,Pepsi,Pull-Non-Working,All Other Non-Working,Other Non Working-non itemised talent,0,0,0,0,0,0,0
LAB North,Puerto Rico,2024,CSD,Pepsi,Pull-Non-Working,All Other Non-Working,PR out of pocket administrative,0,0,0,0,0,0,0
LAB North,Puerto Rico,2024,CSD,Pepsi,Pull-Non-Working,Innovation and Insight,Innovations,0,0,0,0,0,0,0
LAB North,Puerto Rico,2024,CSD,Pepsi,Pull-Non-Working,Innovation and Insight,Market Research,50,145875,72456,73419,145875,72456,73419
LAB North,Puerto Rico,2024,CSD,Pepsi,Pull-Non-Working,Package Design,Package design,0,0,0,0,0,0,0
LAB North,Puerto Rico,2024,CSD,Pepsi,Pull-Non-Working,Package Design,Package development,0,0,0,0,0,0,0
LAB North,Puerto Rico,2024,CSD,Pepsi,STB - Push,Capability Building/Other,Capability Building Other,0,0,0,0,0,0,0
LAB North,Puerto Rico,2024,CSD,Pepsi,STB - Push,Other Investments,CDA's,50,525673,272107,253566,525673,272107,253566
LAB North,Puerto Rico,2024,CSD,Pepsi,STB - Push,Other Investments,Capital (Coolers),0,0,0,0,0,0,0
LAB North,Puerto Rico,2024,CSD,Pepsi,STB - Push,Other Investments,Price Support,50,1528509,794230,734279,1528509,794230,734279
LAB North,Puerto Rico,2024,CSD,Pepsi,STB - Push,Other Investments,Vending / Racks,0,0,0,0,0,0,0
LAB North,Puerto Rico,2024,CSD,Pepsi,STB - Push,Other Trade,Frozen Funds,0,0,0,0,0,0,0
LAB North,Puerto Rico,2024,CSD,Pepsi,STB - Push,Other Trade,Other Trade,50,137232,72641,64591,137232,72641,64591
LAB North,Puerto Rico,2024,CSD,Pepsi,STB - Push,Trade Equipment,Coolers - New,0,0,0,0,0,0,0
LAB North,Puerto Rico,2024,CSD,Pepsi,STB - Push,Trade Equipment,Coolers - Refurbished,0,0,0,0,0,0,0
LAB North,Puerto Rico,2024,CSD,Pepsi,STB - Push,Trade Equipment,Post Mix / Pre Mix Equip.,50,360317,173454,186863,360317,173454,186863
LAB North,Puerto Rico,2024,CSD,Pepsi,STB - Push,Trade Equipment,Vending / Racks,0,0,0,0,0,0,0
LAB North,Puerto Rico,2024,CSD,Pepsi,STB - Push,Trade Programs,Distribution Incentives,0,0,0,0,0,0,0
LAB North,Puerto Rico,2024,CSD,Pepsi,STB - Push,Trade Programs,Innovation Investments,0,0,0,0,0,0,0
LAB North,Puerto Rico,2024,CSD,Pepsi,STB - Push,Trade Programs,Sales Incentives,50,269089,135321,133768,269089,135321,133768
LAB North,Puerto Rico,2024,CSD,Pepsi,STB - Push,Trade Programs,Space Investments,0,0,0,0,0,0,0
LAB North,Puerto Rico,2024,CSD,Pepsi,Pull-Working,All Other Working,Other Working - PR execution,50,4326,2234,2092,4326,2234,2092
LAB North,Puerto Rico,2024,CSD,Pepsi,Pull-Working,All Other Working,Other Working - activation,0,0,0,0,0,0,0
LAB North,Puerto Rico,2024,CSD,Pepsi,Pull-Working,All Other Working,Other Working - non allocated working,0,0,0,0,0,0,0
LAB North,Puerto Rico,2024,CSD,Pepsi,Pull-Working,Consumer Promotions,Consumer Promotions Execution,50,31866,15413,16453,31866,15413,16453
LAB North,Puerto Rico,2024,CSD,Pepsi,Pull-Working,Consumer Promotions,Coupons,0,0,0,0,0,0,0
LAB North,Puerto Rico,2024,CSD,Pepsi,Pull-Working,Consumer Promotions,Other,0,0,0,0,0,0,0
LAB North,Puerto Rico,2024,CSD,Pepsi,Pull-Working,Consumer Promotions,Premiums,50,76291,38133,38158,76291,38133,38158
LAB North,Puerto Rico,2024,CSD,Pepsi,Pull-Working,In Store & POS Execution,In-Store & POS Execution,50,333263,177252,156011,333263,177252,156011
LAB North,Puerto Rico,2024,CSD,Pepsi,Pull-Working,Media Placements,Cinema,0,0,0,0,0,0,0
LAB North,Puerto Rico,2024,CSD,Pepsi,Pull-Working,Media Placements,Digital,50,319620,168226,151394,319620,168226,151394
LAB North,Puerto Rico,2024,CSD,Pepsi,Pull-Working,Media Placements,OOH - Out Of Home,50,330558,156333,174225,330558,156333,174225
LAB North,Puerto Rico,2024,CSD,Pepsi,Pull-Working,Media Placements,Other,0,0,0,0,0,0,0
LAB North,Puerto Rico,2024,CSD,Pepsi,Pull-Working,Media Placements,Print,0,0,0,0,0,0,0
LAB North,Puerto Rico,2024,CSD,Pepsi,Pull-Working,Media Placements,Radio,50,33297,16955,16342,33297,16955,16342
LAB North,Puerto Rico,2024,CSD,Pepsi,Pull-Working,Media Placements,TV,50,91216,45339,45877,91216,45339,45877
LAB North,Puerto Rico,2024,CSD,Pepsi,Pull-Working,Sampling,Product Samples,0,0,0,0,0,0,0
LAB North,Puerto Rico,2024,CSD,Pepsi,Pull-Working,Sampling,Sampling Execution,0,0,0,0,0,0,0
LAB North,Puerto Rico,2024,CSD,Pepsi,Pull-Working,Sponsorships,Sponsorships-in game/ in show,50,296347,149357,146990,296347,149357,146990
LAB North,Puerto Rico,2024,CSD,Pepsi,Pull-Working,Sponsorships,Sports-athlete/team contracts,50,215254,112294,102960,215254,112294,102960
LAB North,Puerto Rico,2024,CSD,Pepsi,Pull-Working,Sponsorships,Sports-on field or in show props,0,0,0,0,0,0,0
LAB North,Puerto Rico,2024,CSD,Pepsi,Pull-Working,Sponsorships,Sports-stadium contracts,0,0,0,0,0,0,0
LAB South,Brazil,2025,Sport Drinks,Gatorade,Pull-Non-Working,Ad Production,Digital Ad Production,50,5393593,2696796,2696797,942243,471121,471122
LAB South,Brazil,2025,Sport Drinks,Gatorade,Pull-Non-Working,Ad Production,Other Ad Production,50,4959595,2479797,2479798,866425,433212,433213
LAB South,Brazil,2025,Sport Drinks,Gatorade,Pull-Non-Working,Ad Production,TV Print Radio OOH Prod,50,434002,217001,217001,75818,37909,37909
LAB South,Brazil,2025,Sport Drinks,Gatorade,Pull-Non-Working,Agency Fees,Creative Agency Fees,50,4848468,2424234,2424234,847011,423505,423506
LAB South,Brazil,2025,Sport Drinks,Gatorade,Pull-Non-Working,Agency Fees,In Store and POS Design/Development,50,3952525,1976262,1976263,690493,345246,345247
LAB South,Brazil,2025,Sport Drinks,Gatorade,Pull-Non-Working,Agency Fees,Media Agency Fees,50,895948,447974,447974,156519,78259,78260
LAB South,Brazil,2025,Sport Drinks,Gatorade,Pull-Non-Working,Agency Fees,Other Agency Fees,50,9774210,4887105,4887105,1707522,853761,853761
LAB South,Brazil,2025,Sport Drinks,Gatorade,Pull-Non-Working,Agency Fees,Social Media/Influence Marketing,50,9774210,4887105,4887105,1707522,853761,853761
LAB South,Brazil,2025,Sport Drinks,Gatorade,Pull-Non-Working,Innovation and Insight,Innovation,50,1578650,789325,789325,275785,137892,137893
LAB South,Brazil,2025,Sport Drinks,Gatorade,Pull-Non-Working,Innovation and Insight,Market Research,50,575663,287831,287832,100566,50283,50283
LAB South,Brazil,2025,Sport Drinks,Gatorade,Pull-Non-Working,Innovation and Insight,Other Innovation and Insight,50,575663,287831,287832,100566,50283,50283
LAB South,Brazil,2025,Sport Drinks,Gatorade,Pull-Non-Working,Insight,Advanced Analytics,50,1002987,501493,501494,175218,87609,87609
LAB South,Brazil,2025,Sport Drinks,Gatorade,Pull-Non-Working,Insight,Brand Building,50,1002987,501493,501494,175218,87609,87609
LAB South,Brazil,2025,Sport Drinks,Gatorade,Pull-Non-Working,Insight,Consumer Tracking,50,31584499,15792249,15792250,5517710,2758854,2758856
LAB South,Brazil,2025,Sport Drinks,Gatorade,Pull-Non-Working,Insight,Customer / Retail and Insights and Analytics,50,7343479,3671739,3671740,1282882,641440,641442
LAB South,Brazil,2025,Sport Drinks,Gatorade,Pull-Non-Working,Insight,Foundational Data / Systems,50,1166855,583427,583428,203845,101922,101923
LAB South,Brazil,2025,Sport Drinks,Gatorade,Pull-Non-Working,Insight,Innovation Insights,50,1608193,804096,804097,280946,140472,140474
LAB South,Brazil,2025,Sport Drinks,Gatorade,Pull-Non-Working,Insight,Strategic Insights,50,4568430,2284215,2284215,798089,399044,399045
LAB South,Brazil,2025,Sport Drinks,Gatorade,Pull-Non-Working,Other Non Working,All Other Non Working,50,2636730,1318365,1318365,460628,230314,230314
LAB South,Brazil,2025,Sport Drinks,Gatorade,Pull-Non-Working,Other Non Working,NW-Cross Charges,50,71101,35550,35551,12421,6210,6211
LAB South,Brazil,2025,Sport Drinks,Gatorade,Pull-Non-Working,Other Non Working,NW-Excluded non-A&M Items,50,430629,215314,215315,75229,37614,37615
LAB South,Brazil,2025,Sport Drinks,Gatorade,Pull-Non-Working,Other Non Working,NW-Fall In / Fall Out,50,2135000,1067500,1067500,372977,186488,186489
LAB South,Brazil,2025,Sport Drinks,Gatorade,Pull-Non-Working,Other Non Working,Out of Scope Countries ( D8 Gastos),50,21604289,10802144,10802145,3774199,1887099,1887100
LAB South,Brazil,2025,Sport Drinks,Gatorade,Pull-Non-Working,Package Design,Other Package Design,50,21604289,10802144,10802145,3774199,1887099,1887100
LAB South,Brazil,2025,Sport Drinks,Gatorade,Pull-Non-Working,Package Design,Package Design,50,45965167,22982583,22982584,8029966,4014983,4014983
LAB South,Brazil,2025,Sport Drinks,Gatorade,Pull-Working,Consumer Promotions,Consumer Promotions Execution,50,6215382,3107691,3107691,1085807,542903,542904
LAB South,Brazil,2025,Sport Drinks,Gatorade,Pull-Working,Consumer Promotions,Coupons (Redemption),50,4796637,2398318,2398319,837957,418978,418979
LAB South,Brazil,2025,Sport Drinks,Gatorade,Pull-Working,Consumer Promotions,Other Consumer Promotions,50,11012020,5506010,5506010,1923764,961882,961882
LAB South,Brazil,2025,Sport Drinks,Gatorade,Pull-Working,Consumer Promotions,Premiums,50,307539,153769,153770,53726,26862,26864
LAB South,Brazil,2025,Sport Drinks,Gatorade,Pull-Working,In Store & POS Execution,In-Store and POS Execution,50,307539,153769,153770,53726,26862,26864
LAB South,Brazil,2025,Sport Drinks,Gatorade,Pull-Working,In Store & POS Execution,Other In-Store and POS Execution,50,4683983,2341991,2341992,818276,409138,409138
LAB South,Brazil,2025,Sport Drinks,Gatorade,Pull-Working,Media Placements,Digital Media,50,4683983,2341991,2341992,818276,409138,409138
LAB South,Brazil,2025,Sport Drinks,Gatorade,Pull-Working,Media Placements,Media Placements,50,19099173,9549586,9549587,3336563,1668281,1668282
LAB South,Brazil,2025,Sport Drinks,Gatorade,Pull-Working,Media Placements,Other Media,50,19099173,9549586,9549587,3336563,1668281,1668282
LAB South,Brazil,2025,Sport Drinks,Gatorade,Pull-Working,Other Working,All Other Working,50,10862450,5431225,5431225,1897634,948817,948817
LAB South,Brazil,2025,Sport Drinks,Gatorade,Pull-Working,Other Working,W-Cross Charges,50,10862450,5431225,5431225,1897634,948817,948817
LAB South,Brazil,2025,Sport Drinks,Gatorade,Pull-Working,Other Working,W-Excluded non-A&M Items,50,32973374,16486687,16486687,5760342,2880171,2880171
LAB South,Brazil,2025,Sport Drinks,Gatorade,Pull-Working,Other Working,W-Fall In / Fall Out,50,5903769,2951884,2951885,1031369,515684,515685
LAB South,Brazil,2025,Sport Drinks,Gatorade,Pull-Working,Sampling,Other Sampling,50,74274,37137,37137,12975,6487,6488
LAB South,Brazil,2025,Sport Drinks,Gatorade,Pull-Working,Sampling,Product Samples,50,937932,468966,468966,163853,81926,81927
LAB South,Brazil,2025,Sport Drinks,Gatorade,Pull-Working,Sampling,Sample Executing,50,23153932,11576966,11576966,4044917,2022458,2022459
LAB South,Brazil,2025,Sport Drinks,Gatorade,Pull-Working,Sponsorships,Other Sponsorships,50,30069904,15034952,15034952,5253115,2626557,2626558
LAB South,Brazil,2025,Sport Drinks,Gatorade,Pull-Working,Sponsorships,Sponsorships,50,2799072,1399536,1399536,488988,244494,244494
LAB South,Brazil,2025,Sport Drinks,Gatorade,STB - Push,Capability Building/Other,Capability Building,50,1720621,860310,860311,300586,150293,150293
LAB South,Brazil,2025,Sport Drinks,Gatorade,STB - Push,Capability Building/Other,Capability Building/Other-Other,50,2903470,1451735,1451735,507226,253613,253613
LAB South,Brazil,2025,Sport Drinks,Gatorade,STB - Push,Trade Equipment,On Premise Equipment,50,46729064,23364532,23364532,8163416,4081708,4081708
LAB South,Brazil,2025,Sport Drinks,Gatorade,STB - Push,Trade Equipment,"Stands/ Racks, Other Trade Equipment",50,24584223,12292111,12292112,4294784,2147392,2147392
LAB South,Brazil,2025,Sport Drinks,Gatorade,STB - Push,Trade Equipment,Trade Equipment-Other,50,9511896,4755948,4755948,1661697,830848,830849
LAB South,Brazil,2025,Sport Drinks,Gatorade,STB - Push,Trade Programs,Distribution Incentives,50,2331469,1165734,1165735,407300,203649,203651
LAB South,Brazil,2025,Sport Drinks,Gatorade,STB - Push,Trade Programs,Innovation Investments,50,3740283,1870141,1870142,653415,326707,326708
LAB South,Brazil,2025,Sport Drinks,Gatorade,STB - Push,Trade Programs,Other Trade Programs,50,40167873,20083936,20083937,7017197,3508598,3508599
LAB South,Brazil,2025,Sport Drinks,Gatorade,STB - Push,Trade Programs,Sales Incentives,50,6561196,3280598,3280598,1146219,573109,573110
LAB South,Brazil,2025,Sport Drinks,Gatorade,STB - Push,Trade Programs,Space Investments,50,6561196,3280598,3280598,1146219,573109,573110
LAB South,Brazil,2025,Sport Drinks,Gatorade,STB - Push,Unilateral,CDAs,50,4230073,2115036,2115037,738980,369489,369491
LAB South,Brazil,2025,Sport Drinks,Gatorade,STB - Push,Unilateral,Capital Equipment,0,0,0,0,0,0,0
LAB South,Brazil,2025,Sport Drinks,Gatorade,STB - Push,Unilateral,Other Unilateral,50,1497308,748654,748654,261574,130787,130787
LAB South,Brazil,2025,Sport Drinks,Gatorade,STB - Push,Unilateral,Price Support,50,2379926,1189963,1189963,415765,207882,207883
LAB South,Brazil,2025,CSD,H2OH,Pull-Non-Working,Ad Production,Digital Ad Production,50,5393596,2696798,2696798,942243,471121,471122
LAB South,Brazil,2025,CSD,H2OH,Pull-Non-Working,Ad Production,Other Ad Production,50,4959594,2479797,2479797,866425,433212,433213
LAB South,Brazil,2025,CSD,H2OH,Pull-Non-Working,Ad Production,TV Print Radio OOH Prod,50,434002,217001,217001,75818,37909,37909
LAB South,Brazil,2025,CSD,H2OH,Pull-Non-Working,Agency Fees,Creative Agency Fees,50,4848467,2424233,2424234,847011,423505,423506
LAB South,Brazil,2025,CSD,H2OH,Pull-Non-Working,Agency Fees,In Store and POS Design/Development,50,3952524,1976262,1976262,690493,345246,345247
LAB South,Brazil,2025,CSD,H2OH,Pull-Non-Working,Agency Fees,Media Agency Fees,50,895948,447974,447974,156519,78259,78260
LAB South,Brazil,2025,CSD,H2OH,Pull-Non-Working,Agency Fees,Other Agency Fees,50,9774208,4887104,4887104,1707522,853761,853761
LAB South,Brazil,2025,CSD,H2OH,Pull-Non-Working,Agency Fees,Social Media/Influence Marketing,50,9774208,4887104,4887104,1707522,853761,853761
LAB South,Brazil,2025,CSD,H2OH,Pull-Non-Working,Innovation and Insight,Innovation,50,1578648,789324,789324,275784,137892,137892
LAB South,Brazil,2025,CSD,H2OH,Pull-Non-Working,Innovation and Insight,Market Research,50,575667,287833,287834,100567,50283,50284
LAB South,Brazil,2025,CSD,H2OH,Pull-Non-Working,Innovation and Insight,Other Innovation and Insight,50,575667,287833,287834,100567,50283,50284
LAB South,Brazil,2025,CSD,H2OH,Pull-Non-Working,Insight,Advanced Analytics,50,1002986,501493,501493,175218,87609,87609
LAB South,Brazil,2025,CSD,H2OH,Pull-Non-Working,Insight,Brand Building,50,1002986,501493,501493,175218,87609,87609
LAB South,Brazil,2025,CSD,H2OH,Pull-Non-Working,Insight,Consumer Tracking,50,31584498,15792249,15792249,5517709,2758854,2758855
LAB South,Brazil,2025,CSD,H2OH,Pull-Non-Working,Insight,Customer / Retail and Insights and Analytics,50,7343478,3671739,3671739,1282881,641440,641441
LAB South,Brazil,2025,CSD,H2OH,Pull-Non-Working,Insight,Foundational Data / Systems,50,1166856,583428,583428,203845,101922,101923
LAB South,Brazil,2025,CSD,H2OH,Pull-Non-Working,Insight,Innovation Insights,50,1608194,804097,804097,280946,140473,140473
LAB South,Brazil,2025,CSD,H2OH,Pull-Non-Working,Insight,Strategic Insights,50,4568427,2284213,2284214,798089,399044,399045
LAB South,Brazil,2025,CSD,H2OH,Pull-Non-Working,Other Non Working,All Other Non Working,50,2636726,1318363,1318363,460627,230313,230314
LAB South,Brazil,2025,CSD,H2OH,Pull-Non-Working,Other Non Working,NW-Cross Charges,50,71097,35548,35549,12420,6210,6210
LAB South,Brazil,2025,CSD,H2OH,Pull-Non-Working,Other Non Working,NW-Excluded non-A&M Items,50,430626,215313,215313,75228,37614,37614
LAB South,Brazil,2025,CSD,H2OH,Pull-Non-Working,Other Non Working,NW-Fall In / Fall Out,50,2135002,1067501,1067501,372977,186488,186489
LAB South,Brazil,2025,CSD,H2OH,Pull-Non-Working,Other Non Working,Out of Scope Countries ( D8 Gastos),50,21604288,10802144,10802144,3774199,1887099,1887100
LAB South,Brazil,2025,CSD,H2OH,Pull-Non-Working,Package Design,Other Package Design,50,21604288,10802144,10802144,3774199,1887099,1887100
LAB South,Brazil,2025,CSD,H2OH,Pull-Non-Working,Package Design,Package Design,50,45965166,22982583,22982583,8029966,4014983,4014983
LAB South,Brazil,2025,CSD,H2OH,Pull-Working,Consumer Promotions,Consumer Promotions Execution,50,6215384,3107692,3107692,1085807,542903,542904
LAB South,Brazil,2025,CSD,H2OH,Pull-Working,Consumer Promotions,Coupons (Redemption),50,4796633,2398316,2398317,837956,418978,418978
LAB South,Brazil,2025,CSD,H2OH,Pull-Working,Consumer Promotions,Other Consumer Promotions,50,11012017,5506008,5506009,1923763,961881,961882
LAB South,Brazil,2025,CSD,H2OH,Pull-Working,Consumer Promotions,Premiums,50,307538,153769,153769,53725,26862,26863
LAB South,Brazil,2025,CSD,H2OH,Pull-Working,In Store & POS Execution,In-Store and POS Execution,50,307538,153769,153769,53725,26862,26863
LAB South,Brazil,2025,CSD,H2OH,Pull-Working,In Store & POS Execution,Other In-Store and POS Execution,50,4683983,2341991,2341992,818276,409138,409138
LAB South,Brazil,2025,CSD,H2OH,Pull-Working,Media Placements,Digital Media,50,4683983,2341991,2341992,818276,409138,409138
LAB South,Brazil,2025,CSD,H2OH,Pull-Working,Media Placements,Media Placements,50,19099173,9549586,9549587,3336563,1668281,1668282
LAB South,Brazil,2025,CSD,H2OH,Pull-Working,Media Placements,Other Media,50,19099173,9549586,9549587,3336563,1668281,1668282
LAB South,Brazil,2025,CSD,H2OH,Pull-Working,Other Working,All Other Working,50,10862452,5431226,5431226,1897635,948817,948818
LAB South,Brazil,2025,CSD,H2OH,Pull-Working,Other Working,W-Cross Charges,50,10862452,5431226,5431226,1897635,948817,948818
LAB South,Brazil,2025,CSD,H2OH,Pull-Working,Other Working,W-Excluded non-A&M Items,50,32973374,16486687,16486687,5760342,2880171,2880171
LAB South,Brazil,2025,CSD,H2OH,Pull-Working,Other Working,W-Fall In / Fall Out,50,5903767,2951883,2951884,1031369,515684,515685
LAB South,Brazil,2025,CSD,H2OH,Pull-Working,Sampling,Other Sampling,50,74272,37136,37136,12975,6487,6488
LAB South,Brazil,2025,CSD,H2OH,Pull-Working,Sampling,Product Samples,50,937930,468965,468965,163853,81926,81927
LAB South,Brazil,2025,CSD,H2OH,Pull-Working,Sampling,Sample Executing,50,23153931,11576965,11576966,4044917,2022458,2022459
LAB South,Brazil,2025,CSD,H2OH,Pull-Working,Sponsorships,Other Sponsorships,50,30069902,15034951,15034951,5253114,2626557,2626557
LAB South,Brazil,2025,CSD,H2OH,Pull-Working,Sponsorships,Sponsorships,50,2799073,1399536,1399537,488989,244494,244495
LAB South,Brazil,2025,CSD,H2OH,STB - Push,Capability Building/Other,Capability Building,50,1720621,860310,860311,300586,150293,150293
LAB South,Brazil,2025,CSD,H2OH,STB - Push,Capability Building/Other,Capability Building/Other-Other,50,2903466,1451733,1451733,507226,253613,253613
LAB South,Brazil,2025,CSD,H2OH,STB - Push,Trade Equipment,On Premise Equipment,50,46729067,23364533,23364534,8163417,4081708,4081709
LAB South,Brazil,2025,CSD,H2OH,STB - Push,Trade Equipment,"Stands/ Racks, Other Trade Equipment",50,24584225,12292112,12292113,4294784,2147392,2147392
LAB South,Brazil,2025,CSD,H2OH,STB - Push,Trade Equipment,Trade Equipment-Other,50,9511898,4755949,4755949,1661697,830848,830849
LAB South,Brazil,2025,CSD,H2OH,STB - Push,Trade Programs,Distribution Incentives,50,2331470,1165735,1165735,407300,203650,203650
LAB South,Brazil,2025,CSD,H2OH,STB - Push,Trade Programs,Innovation Investments,0,0,0,0,0,0,0
LAB South,Brazil,2025,CSD,H2OH,STB - Push,Trade Programs,Other Trade Programs,50,40167873,20083936,20083937,7017197,3508598,3508599
LAB South,Brazil,2025,CSD,H2OH,STB - Push,Trade Programs,Sales Incentives,50,6561194,3280597,3280597,1146219,573109,573110
LAB South,Brazil,2025,CSD,H2OH,STB - Push,Trade Programs,Space Investments,50,6561194,3280597,3280597,1146219,573109,573110
LAB South,Brazil,2025,CSD,H2OH,STB - Push,Unilateral,CDAs,50,4230076,2115038,2115038,738980,369490,369490
LAB South,Brazil,2025,CSD,H2OH,STB - Push,Unilateral,Capital Equipment,50,35385337,17692668,17692669,6181704,3090852,3090852
LAB South,Brazil,2025,CSD,H2OH,STB - Push,Unilateral,Other Unilateral,50,1497307,748653,748654,261574,130787,130787
LAB South,Brazil,2025,CSD,H2OH,STB - Push,Unilateral,Price Support,50,2379928,1189964,1189964,415765,207882,207883
LAB South,Brazil,2025,RTD Tea,Lipton,Pull-Non-Working,Ad Production,Digital Ad Production,50,17056889,8528444,8528445,2979783,1489891,1489892
LAB South,Brazil,2025,RTD Tea,Lipton,Pull-Non-Working,Ad Production,Other Ad Production,50,10221134,5110567,5110567,1785599,892799,892800
LAB South,Brazil,2025,RTD Tea,Lipton,Pull-Non-Working,Ad Production,TV Print Radio OOH Prod,50,35385343,17692671,17692672,6181705,3090852,3090853
LAB South,Brazil,2025,RTD Tea,Lipton,Pull-Non-Working,Agency Fees,Creative Agency Fees,50,973504,486752,486752,170068,85034,85034
LAB South,Brazil,2025,RTD Tea,Lipton,Pull-Non-Working,Agency Fees,In Store and POS Design/Development,50,76797,38398,38399,13416,6708,6708
LAB South,Brazil,2025,RTD Tea,Lipton,Pull-Non-Working,Agency Fees,Media Agency Fees,50,396373,198186,198187,69245,34622,34623
LAB South,Brazil,2025,RTD Tea,Lipton,Pull-Non-Working,Agency Fees,Other Agency Fees,50,500333,250166,250167,87406,43703,43703
LAB South,Brazil,2025,RTD Tea,Lipton,Pull-Non-Working,Agency Fees,Social Media/Influence Marketing,50,973504,486752,486752,170068,85034,85034
LAB South,Brazil,2025,RTD Tea,Lipton,Pull-Non-Working,Innovation and Insight,Innovation,50,12190834,6095417,6095417,2129699,1064849,1064850
LAB South,Brazil,2025,RTD Tea,Lipton,Pull-Non-Working,Innovation and Insight,Market Research,50,1999997,999998,999999,349393,174696,174697
LAB South,Brazil,2025,RTD Tea,Lipton,Pull-Non-Working,Innovation and Insight,Other Innovation and Insight,50,1999997,999998,999999,349393,174696,174697
LAB South,Brazil,2025,RTD Tea,Lipton,Pull-Non-Working,Insight,Advanced Analytics,50,5163897,2581948,2581949,902116,451057,451059
LAB South,Brazil,2025,RTD Tea,Lipton,Pull-Non-Working,Insight,Brand Building,50,1445049,722524,722525,252445,126222,126223
LAB South,Brazil,2025,RTD Tea,Lipton,Pull-Non-Working,Insight,Consumer Tracking,50,754056,377028,377028,131731,65865,65866
LAB South,Brazil,2025,RTD Tea,Lipton,Pull-Non-Working,Insight,Customer / Retail and Insights and Analytics,50,2964791,1482395,1482396,517939,258969,258970
LAB South,Brazil,2025,RTD Tea,Lipton,Pull-Non-Working,Insight,Foundational Data / Systems,50,5163897,2581948,2581949,902116,451057,451059
LAB South,Brazil,2025,RTD Tea,Lipton,Pull-Non-Working,Insight,Innovation Insights,50,5026938,2513469,2513469,878189,439094,439095
LAB South,Brazil,2025,RTD Tea,Lipton,Pull-Non-Working,Insight,Strategic Insights,50,4679039,2339519,2339520,817413,408706,408707
LAB South,Brazil,2025,RTD Tea,Lipton,Pull-Non-Working,Other Non Working,All Other Non Working,50,347898,173949,173949,60776,30388,30388
LAB South,Brazil,2025,RTD Tea,Lipton,Pull-Non-Working,Other Non Working,NW-Cross Charges,50,5026938,2513469,2513469,878189,439094,439095
LAB South,Brazil,2025,RTD Tea,Lipton,Pull-Non-Working,Other Non Working,NW-Excluded non-A&M Items,50,311714719,155857359,155857360,54455555,27227777,27227778
LAB South,Brazil,2025,RTD Tea,Lipton,Pull-Non-Working,Other Non Working,NW-Fall In / Fall Out,50,56281503,28140751,28140752,9832196,4916098,4916098
LAB South,Brazil,2025,RTD Tea,Lipton,Pull-Non-Working,Other Non Working,Out of Scope Countries ( D8 Gastos),50,30838253,15419126,15419127,5387343,2693671,2693672
LAB South,Brazil,2025,RTD Tea,Lipton,Pull-Non-Working,Package Design,Other Package Design,50,5844974,2922487,2922487,1021098,510549,510549
LAB South,Brazil,2025,RTD Tea,Lipton,Pull-Non-Working,Package Design,Package Design,50,5844974,2922487,2922487,1021098,510549,510549
LAB South,Brazil,2025,RTD Tea,Lipton,Pull-Working,Consumer Promotions,Consumer Promotions Execution,50,6137590,3068795,3068795,1072217,536108,536109
LAB South,Brazil,2025,RTD Tea,Lipton,Pull-Working,Consumer Promotions,Coupons (Redemption),50,6137590,3068795,3068795,1072217,536108,536109
LAB South,Brazil,2025,RTD Tea,Lipton,Pull-Working,Consumer Promotions,Other Consumer Promotions,50,9662890,4831445,4831445,1688075,844037,844038
LAB South,Brazil,2025,RTD Tea,Lipton,Pull-Working,Consumer Promotions,Premiums,50,3797809,1898904,1898905,663464,331732,331732
LAB South,Brazil,2025,RTD Tea,Lipton,Pull-Working,In Store & POS Execution,In-Store and POS Execution,50,13460699,6730349,6730350,2351540,1175770,1175770
LAB South,Brazil,2025,RTD Tea,Lipton,Pull-Working,In Store & POS Execution,Other In-Store and POS Execution,50,60163819,30081909,30081910,10510425,5255212,5255213
LAB South,Brazil,2025,RTD Tea,Lipton,Pull-Working,Media Placements,Digital Media,50,2650762,1325381,1325381,463079,231539,231540
LAB South,Brazil,2025,RTD Tea,Lipton,Pull-Working,Media Placements,Media Placements,50,2779837,1389918,1389919,485628,242814,242814
LAB South,Brazil,2025,RTD Tea,Lipton,Pull-Working,Media Placements,Other Media,50,1473518,736759,736759,257418,128709,128709
LAB South,Brazil,2025,RTD Tea,Lipton,Pull-Working,Other Working,All Other Working,50,9660190,4830095,4830095,1687604,843802,843802
LAB South,Brazil,2025,RTD Tea,Lipton,Pull-Working,Other Working,W-Cross Charges,50,16564293,8282146,8282147,2893728,1446864,1446864
LAB South,Brazil,2025,RTD Tea,Lipton,Pull-Working,Other Working,W-Excluded non-A&M Items,50,6090698,3045349,3045349,1064025,532012,532013
LAB South,Brazil,2025,RTD Tea,Lipton,Pull-Working,Other Working,W-Fall In / Fall Out,50,11649996,5824998,5824998,2035216,1017608,1017608
LAB South,Brazil,2025,RTD Tea,Lipton,Pull-Working,Sampling,Other Sampling,50,17740695,8870347,8870348,3099242,1549620,1549622
LAB South,Brazil,2025,RTD Tea,Lipton,Pull-Working,Sampling,Product Samples,50,7151395,3575697,3575698,1249325,624662,624663
LAB South,Brazil,2025,RTD Tea,Lipton,Pull-Working,Sampling,Sample Executing,50,22707430,11353715,11353715,3966914,1983457,1983457
LAB South,Brazil,2025,RTD Tea,Lipton,Pull-Working,Sponsorships,Other Sponsorships,50,25858815,12929407,12929408,4517451,2258725,2258726
LAB South,Brazil,2025,RTD Tea,Lipton,Pull-Working,Sponsorships,Sponsorships,50,195269381,97634690,97634691,34112930,17056465,17056465
LAB South,Brazil,2025,RTD Tea,Lipton,STB - Push,Capability Building/Other,Capability Building,50,169490005,84745002,84745003,29609356,14804678,14804678
LAB South,Brazil,2025,RTD Tea,Lipton,STB - Push,Capability Building/Other,Capability Building/Other-Other,50,169490005,84745002,84745003,29609356,14804678,14804678
LAB South,Brazil,2025,RTD Tea,Lipton,STB - Push,Trade Equipment,On Premise Equipment,50,1201284,600642,600642,209860,104930,104930
LAB South,Brazil,2025,RTD Tea,Lipton,STB - Push,Trade Equipment,"Stands/ Racks, Other Trade Equipment",50,19322660,9661330,9661330,3375606,1687803,1687803
LAB South,Brazil,2025,RTD Tea,Lipton,STB - Push,Trade Equipment,Trade Equipment-Other,50,5255445,2627722,2627723,918109,459054,459055
LAB South,Brazil,2025,RTD Tea,Lipton,STB - Push,Trade Programs,Distribution Incentives,50,25779390,12889695,12889695,4503576,2251788,2251788
LAB South,Brazil,2025,RTD Tea,Lipton,STB - Push,Trade Programs,Innovation Investments,50,26542404,13271202,13271202,4636872,2318436,2318436
LAB South,Brazil,2025,RTD Tea,Lipton,STB - Push,Trade Programs,Other Trade Programs,50,5369684,2684842,2684842,938066,469033,469033
LAB South,Brazil,2025,RTD Tea,Lipton,STB - Push,Trade Programs,Sales Incentives,50,232527,116263,116264,40621,20310,20311
LAB South,Brazil,2025,RTD Tea,Lipton,STB - Push,Trade Programs,Space Investments,50,1914242,957121,957121,334411,167205,167206
LAB South,Brazil,2025,RTD Tea,Lipton,STB - Push,Unilateral,CDAs,50,5997888,2998944,2998944,1047811,523905,523906
LAB South,Brazil,2025,RTD Tea,Lipton,STB - Push,Unilateral,Capital Equipment,0,0,0,0,0,0,0
LAB South,Brazil,2025,RTD Tea,Lipton,STB - Push,Unilateral,Other Unilateral,50,40271301,20135650,20135651,7035266,3517633,3517633
LAB South,Brazil,2025,RTD Tea,Lipton,STB - Push,Unilateral,Price Support,50,39060536,19530268,19530268,6823749,3411874,3411875
LAB South,Brazil,2025,CSD,Pepsi,Pull-Non-Working,Ad Production,Digital Ad Production,50,5393593,2696796,2696797,942243,471121,471122
LAB South,Brazil,2025,CSD,Pepsi,Pull-Non-Working,Ad Production,Other Ad Production,50,4959595,2479797,2479798,866425,433212,433213
LAB South,Brazil,2025,CSD,Pepsi,Pull-Non-Working,Ad Production,TV Print Radio OOH Prod,50,434002,217001,217001,75818,37909,37909
LAB South,Brazil,2025,CSD,Pepsi,Pull-Non-Working,Agency Fees,Creative Agency Fees,50,4848468,2424234,2424234,847011,423505,423506
LAB South,Brazil,2025,CSD,Pepsi,Pull-Non-Working,Agency Fees,In Store and POS Design/Development,50,3952525,1976262,1976263,690493,345246,345247
LAB South,Brazil,2025,CSD,Pepsi,Pull-Non-Working,Agency Fees,Media Agency Fees,50,895948,447974,447974,156519,78259,78260
LAB South,Brazil,2025,CSD,Pepsi,Pull-Non-Working,Agency Fees,Other Agency Fees,50,9774210,4887105,4887105,1707522,853761,853761
LAB South,Brazil,2025,CSD,Pepsi,Pull-Non-Working,Agency Fees,Social Media/Influence Marketing,50,9774210,4887105,4887105,1707522,853761,853761
LAB South,Brazil,2025,CSD,Pepsi,Pull-Non-Working,Innovation and Insight,Innovation,50,1578650,789325,789325,275785,137892,137893
LAB South,Brazil,2025,CSD,Pepsi,Pull-Non-Working,Innovation and Insight,Market Research,50,575663,287831,287832,100566,50283,50283
LAB South,Brazil,2025,CSD,Pepsi,Pull-Non-Working,Innovation and Insight,Other Innovation and Insight,50,575663,287831,287832,100566,50283,50283
LAB South,Brazil,2025,CSD,Pepsi,Pull-Non-Working,Insight,Advanced Analytics,50,1002987,501493,501494,175218,87609,87609
LAB South,Brazil,2025,CSD,Pepsi,Pull-Non-Working,Insight,Brand Building,50,1002987,501493,501494,175218,87609,87609
LAB South,Brazil,2025,CSD,Pepsi,Pull-Non-Working,Insight,Consumer Tracking,50,31584499,15792249,15792250,5517710,2758854,2758856
LAB South,Brazil,2025,CSD,Pepsi,Pull-Non-Working,Insight,Customer / Retail and Insights and Analytics,50,7343479,3671739,3671740,1282882,641440,641442
LAB South,Brazil,2025,CSD,Pepsi,Pull-Non-Working,Insight,Foundational Data / Systems,50,1166855,583427,583428,203845,101922,101923
LAB South,Brazil,2025,CSD,Pepsi,Pull-Non-Working,Insight,Innovation Insights,50,1608193,804096,804097,280946,140472,140474
LAB South,Brazil,2025,CSD,Pepsi,Pull-Non-Working,Insight,Strategic Insights,50,4568430,2284215,2284215,798089,399044,399045
LAB South,Brazil,2025,CSD,Pepsi,Pull-Non-Working,Other Non Working,All Other Non Working,50,2636730,1318365,1318365,460628,230314,230314
LAB South,Brazil,2025,CSD,Pepsi,Pull-Non-Working,Other Non Working,NW-Cross Charges,50,71101,35550,35551,12421,6210,6211
LAB South,Brazil,2025,CSD,Pepsi,Pull-Non-Working,Other Non Working,NW-Excluded non-A&M Items,50,430629,215314,215315,75229,37614,37615
LAB South,Brazil,2025,CSD,Pepsi,Pull-Non-Working,Other Non Working,NW-Fall In / Fall Out,50,2135000,1067500,1067500,372977,186488,186489
LAB South,Brazil,2025,CSD,Pepsi,Pull-Non-Working,Other Non Working,Out of Scope Countries ( D8 Gastos),50,21604289,10802144,10802145,3774199,1887099,1887100
LAB South,Brazil,2025,CSD,Pepsi,Pull-Non-Working,Package Design,Other Package Design,50,21604289,10802144,10802145,3774199,1887099,1887100
LAB South,Brazil,2025,CSD,Pepsi,Pull-Non-Working,Package Design,Package Design,50,45965167,22982583,22982584,8029966,4014983,4014983
LAB South,Brazil,2025,CSD,Pepsi,Pull-Working,Consumer Promotions,Consumer Promotions Execution,50,6215382,3107691,3107691,1085807,542903,542904
LAB South,Brazil,2025,CSD,Pepsi,Pull-Working,Consumer Promotions,Coupons (Redemption),50,4796637,2398318,2398319,837957,418978,418979
LAB South,Brazil,2025,CSD,Pepsi,Pull-Working,Consumer Promotions,Other Consumer Promotions,50,11012020,5506010,5506010,1923764,961882,961882
LAB South,Brazil,2025,CSD,Pepsi,Pull-Working,Consumer Promotions,Premiums,50,307539,153769,153770,53726,26862,26864
LAB South,Brazil,2025,CSD,Pepsi,Pull-Working,In Store & POS Execution,In-Store and POS Execution,50,307539,153769,153770,53726,26862,26864
LAB South,Brazil,2025,CSD,Pepsi,Pull-Working,In Store & POS Execution,Other In-Store and POS Execution,50,4683983,2341991,2341992,818276,409138,409138
LAB South,Brazil,2025,CSD,Pepsi,Pull-Working,Media Placements,Digital Media,50,4683983,2341991,2341992,818276,409138,409138
LAB South,Brazil,2025,CSD,Pepsi,Pull-Working,Media Placements,Media Placements,50,19099173,9549586,9549587,3336563,1668281,1668282
LAB South,Brazil,2025,CSD,Pepsi,Pull-Working,Media Placements,Other Media,50,19099173,9549586,9549587,3336563,1668281,1668282
LAB South,Brazil,2025,CSD,Pepsi,Pull-Working,Other Working,All Other Working,50,10862450,5431225,5431225,1897634,948817,948817
LAB South,Brazil,2025,CSD,Pepsi,Pull-Working,Other Working,W-Cross Charges,50,10862450,5431225,5431225,1897634,948817,948817
LAB South,Brazil,2025,CSD,Pepsi,Pull-Working,Other Working,W-Excluded non-A&M Items,50,32973374,16486687,16486687,5760342,2880171,2880171
LAB South,Brazil,2025,CSD,Pepsi,Pull-Working,Other Working,W-Fall In / Fall Out,50,5903769,2951884,2951885,1031369,515684,515685
LAB South,Brazil,2025,CSD,Pepsi,Pull-Working,Sampling,Other Sampling,50,74274,37137,37137,12975,6487,6488
LAB South,Brazil,2025,CSD,Pepsi,Pull-Working,Sampling,Product Samples,50,937932,468966,468966,163853,81926,81927
LAB South,Brazil,2025,CSD,Pepsi,Pull-Working,Sampling,Sample Executing,50,23153932,11576966,11576966,4044917,2022458,2022459
LAB South,Brazil,2025,CSD,Pepsi,Pull-Working,Sponsorships,Other Sponsorships,50,30069904,15034952,15034952,5253115,2626557,2626558
LAB South,Brazil,2025,CSD,Pepsi,Pull-Working,Sponsorships,Sponsorships,50,2799072,1399536,1399536,488988,244494,244494
LAB South,Brazil,2025,CSD,Pepsi,STB - Push,Capability Building/Other,Capability Building,50,1720621,860310,860311,300586,150293,150293
LAB South,Brazil,2025,CSD,Pepsi,STB - Push,Capability Building/Other,Capability Building/Other-Other,50,2903470,1451735,1451735,507226,253613,253613
LAB South,Brazil,2025,CSD,Pepsi,STB - Push,Trade Equipment,On Premise Equipment,50,46729064,23364532,23364532,8163416,4081708,4081708
LAB South,Brazil,2025,CSD,Pepsi,STB - Push,Trade Equipment,"Stands/ Racks, Other Trade Equipment",50,24584223,12292111,12292112,4294784,2147392,2147392
LAB South,Brazil,2025,CSD,Pepsi,STB - Push,Trade Equipment,Trade Equipment-Other,50,9511896,4755948,4755948,1661697,830848,830849
LAB South,Brazil,2025,CSD,Pepsi,STB - Push,Trade Programs,Distribution Incentives,50,2331469,1165734,1165735,407300,203649,203651
LAB South,Brazil,2025,CSD,Pepsi,STB - Push,Trade Programs,Innovation Investments,50,3740283,1870141,1870142,653415,326707,326708
LAB South,Brazil,2025,CSD,Pepsi,STB - Push,Trade Programs,Other Trade Programs,50,40167873,20083936,20083937,7017197,3508598,3508599
LAB South,Brazil,2025,CSD,Pepsi,STB - Push,Trade Programs,Sales Incentives,50,6561196,3280598,3280598,1146219,573109,573110
LAB South,Brazil,2025,CSD,Pepsi,STB - Push,Trade Programs,Space Investments,50,6561196,3280598,3280598,1146219,573109,573110
LAB South,Brazil,2025,CSD,Pepsi,STB - Push,Unilateral,CDAs,50,4230073,2115036,2115037,738980,369489,369491
LAB South,Brazil,2025,CSD,Pepsi,STB - Push,Unilateral,Capital Equipment,0,0,0,0,0,0,0
LAB South,Brazil,2025,CSD,Pepsi,STB - Push,Unilateral,Other Unilateral,50,1497308,748654,748654,261574,130787,130787
LAB South,Brazil,2025,CSD,Pepsi,STB - Push,Unilateral,Price Support,50,2379926,1189963,1189963,415765,207882,207883
LAB South,Brazil,2025,CSD,TEEM,Pull-Non-Working,Ad Production,Digital Ad Production,50,17056889,8528444,8528445,2979783,1489891,1489892
LAB South,Brazil,2025,CSD,TEEM,Pull-Non-Working,Ad Production,Other Ad Production,50,10221134,5110567,5110567,1785599,892799,892800
LAB South,Brazil,2025,CSD,TEEM,Pull-Non-Working,Ad Production,TV Print Radio OOH Prod,50,35385343,17692671,17692672,6181705,3090852,3090853
LAB South,Brazil,2025,CSD,TEEM,Pull-Non-Working,Agency Fees,Creative Agency Fees,50,973504,486752,486752,170068,85034,85034
LAB South,Brazil,2025,CSD,TEEM,Pull-Non-Working,Agency Fees,In Store and POS Design/Development,50,76797,38398,38399,13416,6708,6708
LAB South,Brazil,2025,CSD,TEEM,Pull-Non-Working,Agency Fees,Media Agency Fees,50,396373,198186,198187,69245,34622,34623
LAB South,Brazil,2025,CSD,TEEM,Pull-Non-Working,Agency Fees,Other Agency Fees,50,500333,250166,250167,87406,43703,43703
LAB South,Brazil,2025,CSD,TEEM,Pull-Non-Working,Agency Fees,Social Media/Influence Marketing,50,973504,486752,486752,170068,85034,85034
LAB South,Brazil,2025,CSD,TEEM,Pull-Non-Working,Innovation and Insight,Innovation,50,12190834,6095417,6095417,2129699,1064849,1064850
LAB South,Brazil,2025,CSD,TEEM,Pull-Non-Working,Innovation and Insight,Market Research,50,1999997,999998,999999,349393,174696,174697
LAB South,Brazil,2025,CSD,TEEM,Pull-Non-Working,Innovation and Insight,Other Innovation and Insight,50,1999997,999998,999999,349393,174696,174697
LAB South,Brazil,2025,CSD,TEEM,Pull-Non-Working,Insight,Advanced Analytics,50,5163897,2581948,2581949,902116,451057,451059
LAB South,Brazil,2025,CSD,TEEM,Pull-Non-Working,Insight,Brand Building,50,1445049,722524,722525,252445,126222,126223
LAB South,Brazil,2025,CSD,TEEM,Pull-Non-Working,Insight,Consumer Tracking,50,754056,377028,377028,131731,65865,65866
LAB South,Brazil,2025,CSD,TEEM,Pull-Non-Working,Insight,Customer / Retail and Insights and Analytics,50,2964791,1482395,1482396,517939,258969,258970
LAB South,Brazil,2025,CSD,TEEM,Pull-Non-Working,Insight,Foundational Data / Systems,50,5163897,2581948,2581949,902116,451057,451059
LAB South,Brazil,2025,CSD,TEEM,Pull-Non-Working,Insight,Innovation Insights,50,5026938,2513469,2513469,878189,439094,439095
LAB South,Brazil,2025,CSD,TEEM,Pull-Non-Working,Insight,Strategic Insights,50,4679039,2339519,2339520,817413,408706,408707
LAB South,Brazil,2025,CSD,TEEM,Pull-Non-Working,Other Non Working,All Other Non Working,50,347898,173949,173949,60776,30388,30388
LAB South,Brazil,2025,CSD,TEEM,Pull-Non-Working,Other Non Working,NW-Cross Charges,50,5026938,2513469,2513469,878189,439094,439095
LAB South,Brazil,2025,CSD,TEEM,Pull-Non-Working,Other Non Working,NW-Excluded non-A&M Items,50,311714719,155857359,155857360,54455555,27227777,27227778
LAB South,Brazil,2025,CSD,TEEM,Pull-Non-Working,Other Non Working,NW-Fall In / Fall Out,50,56281503,28140751,28140752,9832196,4916098,4916098
LAB South,Brazil,2025,CSD,TEEM,Pull-Non-Working,Other Non Working,Out of Scope Countries ( D8 Gastos),50,30838253,15419126,15419127,5387343,2693671,2693672
LAB South,Brazil,2025,CSD,TEEM,Pull-Non-Working,Package Design,Other Package Design,50,5844974,2922487,2922487,1021098,510549,510549
LAB South,Brazil,2025,CSD,TEEM,Pull-Non-Working,Package Design,Package Design,50,5844974,2922487,2922487,1021098,510549,510549
LAB South,Brazil,2025,CSD,TEEM,Pull-Working,Consumer Promotions,Consumer Promotions Execution,50,6137590,3068795,3068795,1072217,536108,536109
LAB South,Brazil,2025,CSD,TEEM,Pull-Working,Consumer Promotions,Coupons (Redemption),50,6137590,3068795,3068795,1072217,536108,536109
LAB South,Brazil,2025,CSD,TEEM,Pull-Working,Consumer Promotions,Other Consumer Promotions,50,9662890,4831445,4831445,1688075,844037,844038
LAB South,Brazil,2025,CSD,TEEM,Pull-Working,Consumer Promotions,Premiums,50,3797809,1898904,1898905,663464,331732,331732
LAB South,Brazil,2025,CSD,TEEM,Pull-Working,In Store & POS Execution,In-Store and POS Execution,50,13460699,6730349,6730350,2351540,1175770,1175770
LAB South,Brazil,2025,CSD,TEEM,Pull-Working,In Store & POS Execution,Other In-Store and POS Execution,50,60163819,30081909,30081910,10510425,5255212,5255213
LAB South,Brazil,2025,CSD,TEEM,Pull-Working,Media Placements,Digital Media,50,2650762,1325381,1325381,463079,231539,231540
LAB South,Brazil,2025,CSD,TEEM,Pull-Working,Media Placements,Media Placements,50,2779837,1389918,1389919,485628,242814,242814
LAB South,Brazil,2025,CSD,TEEM,Pull-Working,Media Placements,Other Media,50,1473518,736759,736759,257418,128709,128709
LAB South,Brazil,2025,CSD,TEEM,Pull-Working,Other Working,All Other Working,50,9660190,4830095,4830095,1687604,843802,843802
LAB South,Brazil,2025,CSD,TEEM,Pull-Working,Other Working,W-Cross Charges,50,16564293,8282146,8282147,2893728,1446864,1446864
LAB South,Brazil,2025,CSD,TEEM,Pull-Working,Other Working,W-Excluded non-A&M Items,50,6090698,3045349,3045349,1064025,532012,532013
LAB South,Brazil,2025,CSD,TEEM,Pull-Working,Other Working,W-Fall In / Fall Out,50,11649996,5824998,5824998,2035216,1017608,1017608
LAB South,Brazil,2025,CSD,TEEM,Pull-Working,Sampling,Other Sampling,50,17740695,8870347,8870348,3099242,1549620,1549622
LAB South,Brazil,2025,CSD,TEEM,Pull-Working,Sampling,Product Samples,50,7151395,3575697,3575698,1249325,624662,624663
LAB South,Brazil,2025,CSD,TEEM,Pull-Working,Sampling,Sample Executing,50,22707430,11353715,11353715,3966914,1983457,1983457
LAB South,Brazil,2025,CSD,TEEM,Pull-Working,Sponsorships,Other Sponsorships,50,25858815,12929407,12929408,4517451,2258725,2258726
LAB South,Brazil,2025,CSD,TEEM,Pull-Working,Sponsorships,Sponsorships,50,195269381,97634690,97634691,34112930,17056465,17056465
LAB South,Brazil,2025,CSD,TEEM,STB - Push,Capability Building/Other,Capability Building,50,169490005,84745002,84745003,29609356,14804678,14804678
LAB South,Brazil,2025,CSD,TEEM,STB - Push,Capability Building/Other,Capability Building/Other-Other,50,169490005,84745002,84745003,29609356,14804678,14804678
LAB South,Brazil,2025,CSD,TEEM,STB - Push,Trade Equipment,On Premise Equipment,50,1201284,600642,600642,209860,104930,104930
LAB South,Brazil,2025,CSD,TEEM,STB - Push,Trade Equipment,"Stands/ Racks, Other Trade Equipment",50,19322660,9661330,9661330,3375606,1687803,1687803
LAB South,Brazil,2025,CSD,TEEM,STB - Push,Trade Equipment,Trade Equipment-Other,50,5255445,2627722,2627723,918109,459054,459055
LAB South,Brazil,2025,CSD,TEEM,STB - Push,Trade Programs,Distribution Incentives,50,25779390,12889695,12889695,4503576,2251788,2251788
LAB South,Brazil,2025,CSD,TEEM,STB - Push,Trade Programs,Innovation Investments,50,26542404,13271202,13271202,4636872,2318436,2318436
LAB South,Brazil,2025,CSD,TEEM,STB - Push,Trade Programs,Other Trade Programs,50,5369684,2684842,2684842,938066,469033,469033
LAB South,Brazil,2025,CSD,TEEM,STB - Push,Trade Programs,Sales Incentives,50,232527,116263,116264,40621,20310,20311
LAB South,Brazil,2025,CSD,TEEM,STB - Push,Trade Programs,Space Investments,50,1914242,957121,957121,334411,167205,167206
LAB South,Brazil,2025,CSD,TEEM,STB - Push,Unilateral,CDAs,50,5997888,2998944,2998944,1047811,523905,523906
LAB South,Brazil,2025,CSD,TEEM,STB - Push,Unilateral,Capital Equipment,0,0,0,0,0,0,0
LAB South,Brazil,2025,CSD,TEEM,STB - Push,Unilateral,Other Unilateral,50,40271301,20135650,20135651,7035266,3517633,3517633
LAB South,Brazil,2025,CSD,TEEM,STB - Push,Unilateral,Price Support,50,39060536,19530268,19530268,6823749,3411874,3411875
LAB North,El Salvador,2025,Sport Drinks,Gatorade,Pull-Non-Working,Ad Production,Digital Ad Production,0,0,0,0,0,0,0
LAB North,El Salvador,2025,Sport Drinks,Gatorade,Pull-Non-Working,Ad Production,"TV, Print, Radio, OOH, Production",0,0,0,0,0,0,0
LAB North,El Salvador,2025,Sport Drinks,Gatorade,Pull-Non-Working,Agency Fees,Creative Agency Fees,50,12000,6000,6000,12000,6000,6000
LAB North,El Salvador,2025,Sport Drinks,Gatorade,Pull-Non-Working,Agency Fees,In Store & POS Design / Development,0,0,0,0,0,0,0
LAB North,El Salvador,2025,Sport Drinks,Gatorade,Pull-Non-Working,Agency Fees,Media Agency Fees,50,146040,73020,73020,146040,73020,73020
LAB North,El Salvador,2025,Sport Drinks,Gatorade,Pull-Non-Working,Agency Fees,Other,50,57297,28648,28649,57297,28648,28649
LAB North,El Salvador,2025,Sport Drinks,Gatorade,Pull-Non-Working,Agency Fees,Social Media / Influence Marketing,0,0,0,0,0,0,0
LAB North,El Salvador,2025,Sport Drinks,Gatorade,Pull-Non-Working,All Other Non-Working,Administrative fees,0,0,0,0,0,0,0
LAB North,El Salvador,2025,Sport Drinks,Gatorade,Pull-Non-Working,All Other Non-Working,Agency out of pocket,0,0,0,0,0,0,0
LAB North,El Salvador,2025,Sport Drinks,Gatorade,Pull-Non-Working,All Other Non-Working,CP out of pocket admin,0,0,0,0,0,0,0
LAB North,El Salvador,2025,Sport Drinks,Gatorade,Pull-Non-Working,All Other Non-Working,Grassroots/experiential out of pocket,0,0,0,0,0,0,0
LAB North,El Salvador,2025,Sport Drinks,Gatorade,Pull-Non-Working,All Other Non-Working,League/property- rights fee/options,0,0,0,0,0,0,0
LAB North,El Salvador,2025,Sport Drinks,Gatorade,Pull-Non-Working,All Other Non-Working,Market Research,0,0,0,0,0,0,0
LAB North,El Salvador,2025,Sport Drinks,Gatorade,Pull-Non-Working,All Other Non-Working,Non-allocated NW,0,0,0,0,0,0,0
LAB North,El Salvador,2025,Sport Drinks,Gatorade,Pull-Non-Working,All Other Non-Working,Other Non Working-non itemised talent,0,0,0,0,0,0,0
LAB North,El Salvador,2025,Sport Drinks,Gatorade,Pull-Non-Working,All Other Non-Working,PR out of pocket administrative,0,0,0,0,0,0,0
LAB North,El Salvador,2025,Sport Drinks,Gatorade,Pull-Non-Working,Innovation and Insight,Innovations,0,0,0,0,0,0,0
LAB North,El Salvador,2025,Sport Drinks,Gatorade,Pull-Non-Working,Innovation and Insight,Market Research,0,0,0,0,0,0,0
LAB North,El Salvador,2025,Sport Drinks,Gatorade,Pull-Non-Working,Package Design,Package design,0,0,0,0,0,0,0
LAB North,El Salvador,2025,Sport Drinks,Gatorade,Pull-Non-Working,Package Design,Package development,50,50000,25000,25000,50000,25000,25000
LAB North,El Salvador,2025,Sport Drinks,Gatorade,STB - Push,Capability Building/Other,Capability Building Other,50,70968,35484,35484,70968,35484,35484
LAB North,El Salvador,2025,Sport Drinks,Gatorade,STB - Push,Other Investments,CDA's,50,157809,78904,78905,157809,78904,78905
LAB North,El Salvador,2025,Sport Drinks,Gatorade,STB - Push,Other Investments,Capital (Coolers),0,0,0,0,0,0,0
LAB North,El Salvador,2025,Sport Drinks,Gatorade,STB - Push,Other Investments,Price Support,50,837588,418794,418794,837588,418794,418794
LAB North,El Salvador,2025,Sport Drinks,Gatorade,STB - Push,Other Investments,Vending / Racks,0,0,0,0,0,0,0
LAB North,El Salvador,2025,Sport Drinks,Gatorade,STB - Push,Other Trade,Frozen Funds,0,0,0,0,0,0,0
LAB North,El Salvador,2025,Sport Drinks,Gatorade,STB - Push,Other Trade,Other Trade,0,0,0,0,0,0,0
LAB North,El Salvador,2025,Sport Drinks,Gatorade,STB - Push,Trade Equipment,Coolers - New,0,0,0,0,0,0,0
LAB North,El Salvador,2025,Sport Drinks,Gatorade,STB - Push,Trade Equipment,Coolers - Refurbished,0,0,0,0,0,0,0
LAB North,El Salvador,2025,Sport Drinks,Gatorade,STB - Push,Trade Equipment,Post Mix / Pre Mix Equip.,0,0,0,0,0,0,0
LAB North,El Salvador,2025,Sport Drinks,Gatorade,STB - Push,Trade Equipment,Vending / Racks,0,0,0,0,0,0,0
LAB North,El Salvador,2025,Sport Drinks,Gatorade,STB - Push,Trade Programs,Distribution Incentives,0,0,0,0,0,0,0
LAB North,El Salvador,2025,Sport Drinks,Gatorade,STB - Push,Trade Programs,Innovation Investments,0,0,0,0,0,0,0
LAB North,El Salvador,2025,Sport Drinks,Gatorade,STB - Push,Trade Programs,Sales Incentives,0,0,0,0,0,0,0
LAB North,El Salvador,2025,Sport Drinks,Gatorade,STB - Push,Trade Programs,Space Investments,50,1845478,922739,922739,1845478,922739,922739
LAB North,El Salvador,2025,Sport Drinks,Gatorade,Pull-Working,All Other Working,Other Working - PR execution,0,0,0,0,0,0,0
LAB North,El Salvador,2025,Sport Drinks,Gatorade,Pull-Working,All Other Working,Other Working - activation,50,152179,76089,76090,152179,76089,76090
LAB North,El Salvador,2025,Sport Drinks,Gatorade,Pull-Working,All Other Working,Other Working - non allocated working,0,0,0,0,0,0,0
LAB North,El Salvador,2025,Sport Drinks,Gatorade,Pull-Working,Consumer Promotions,Consumer Promotions Execution,50,46213,23106,23107,46213,23106,23107
LAB North,El Salvador,2025,Sport Drinks,Gatorade,Pull-Working,Consumer Promotions,Coupons,50,596682,298341,298341,596682,298341,298341
LAB North,El Salvador,2025,Sport Drinks,Gatorade,Pull-Working,Consumer Promotions,Other,0,0,0,0,0,0,0
LAB North,El Salvador,2025,Sport Drinks,Gatorade,Pull-Working,Consumer Promotions,Premiums,50,20000,10000,10000,20000,10000,10000
LAB North,El Salvador,2025,Sport Drinks,Gatorade,Pull-Working,In Store & POS Execution,In-Store & POS Execution,50,55000,27500,27500,55000,27500,27500
LAB North,El Salvador,2025,Sport Drinks,Gatorade,Pull-Working,Media Placements,Cinema,0,0,0,0,0,0,0
LAB North,El Salvador,2025,Sport Drinks,Gatorade,Pull-Working,Media Placements,Digital,50,312999,156499,156500,312999,156499,156500
LAB North,El Salvador,2025,Sport Drinks,Gatorade,Pull-Working,Media Placements,OOH - Out Of Home,0,0,0,0,0,0,0
LAB North,El Salvador,2025,Sport Drinks,Gatorade,Pull-Working,Media Placements,Other,0,0,0,0,0,0,0
LAB North,El Salvador,2025,Sport Drinks,Gatorade,Pull-Working,Media Placements,Print,0,0,0,0,0,0,0
LAB North,El Salvador,2025,Sport Drinks,Gatorade,Pull-Working,Media Placements,Radio,50,129999,64999,65000,129999,64999,65000
LAB North,El Salvador,2025,Sport Drinks,Gatorade,Pull-Working,Media Placements,TV,0,0,0,0,0,0,0
LAB North,El Salvador,2025,Sport Drinks,Gatorade,Pull-Working,Sampling,Product Samples,0,0,0,0,0,0,0
LAB North,El Salvador,2025,Sport Drinks,Gatorade,Pull-Working,Sampling,Sampling Execution,0,0,0,0,0,0,0
LAB North,El Salvador,2025,Sport Drinks,Gatorade,Pull-Working,Sponsorships,Sponsorships-in game/ in show,50,169023,84511,84512,169023,84511,84512
LAB North,El Salvador,2025,Sport Drinks,Gatorade,Pull-Working,Sponsorships,Sports-athlete/team contracts,50,95460,47730,47730,95460,47730,47730
LAB North,El Salvador,2025,Sport Drinks,Gatorade,Pull-Working,Sponsorships,Sports-on field or in show props,0,0,0,0,0,0,0
LAB North,El Salvador,2025,Sport Drinks,Gatorade,Pull-Working,Sponsorships,Sports-stadium contracts,0,0,0,0,0,0,0
LAB North,El Salvador,2025,CSD,Pepsi,Pull-Non-Working,Ad Production,Digital Ad Production,0,0,0,0,0,0,0
LAB North,El Salvador,2025,CSD,Pepsi,Pull-Non-Working,Ad Production,"TV, Print, Radio, OOH, Production",0,0,0,0,0,0,0
LAB North,El Salvador,2025,CSD,Pepsi,Pull-Non-Working,Agency Fees,Creative Agency Fees,0,0,0,0,0,0,0
LAB North,El Salvador,2025,CSD,Pepsi,Pull-Non-Working,Agency Fees,In Store & POS Design / Development,0,0,0,0,0,0,0
LAB North,El Salvador,2025,CSD,Pepsi,Pull-Non-Working,Agency Fees,Media Agency Fees,50,297499,148749,148750,297499,148749,148750
LAB North,El Salvador,2025,CSD,Pepsi,Pull-Non-Working,Agency Fees,Other,50,53381,26690,26691,53381,26690,26691
LAB North,El Salvador,2025,CSD,Pepsi,Pull-Non-Working,Agency Fees,Social Media / Influence Marketing,0,0,0,0,0,0,0
LAB North,El Salvador,2025,CSD,Pepsi,Pull-Non-Working,All Other Non-Working,Administrative fees,0,0,0,0,0,0,0
LAB North,El Salvador,2025,CSD,Pepsi,Pull-Non-Working,All Other Non-Working,Agency out of pocket,0,0,0,0,0,0,0
LAB North,El Salvador,2025,CSD,Pepsi,Pull-Non-Working,All Other Non-Working,CP out of pocket admin,0,0,0,0,0,0,0
LAB North,El Salvador,2025,CSD,Pepsi,Pull-Non-Working,All Other Non-Working,Grassroots/experiential out of pocket,0,0,0,0,0,0,0
LAB North,El Salvador,2025,CSD,Pepsi,Pull-Non-Working,All Other Non-Working,League/property- rights fee/options,0,0,0,0,0,0,0
LAB North,El Salvador,2025,CSD,Pepsi,Pull-Non-Working,All Other Non-Working,Market Research,0,0,0,0,0,0,0
LAB North,El Salvador,2025,CSD,Pepsi,Pull-Non-Working,All Other Non-Working,Non-allocated NW,0,0,0,0,0,0,0
LAB North,El Salvador,2025,CSD,Pepsi,Pull-Non-Working,All Other Non-Working,Other Non Working-non itemised talent,0,0,0,0,0,0,0
LAB North,El Salvador,2025,CSD,Pepsi,Pull-Non-Working,All Other Non-Working,PR out of pocket administrative,0,0,0,0,0,0,0
LAB North,El Salvador,2025,CSD,Pepsi,Pull-Non-Working,Innovation and Insight,Innovations,0,0,0,0,0,0,0
LAB North,El Salvador,2025,CSD,Pepsi,Pull-Non-Working,Innovation and Insight,Market Research,0,0,0,0,0,0,0
LAB North,El Salvador,2025,CSD,Pepsi,Pull-Non-Working,Package Design,Package design,0,0,0,0,0,0,0
LAB North,El Salvador,2025,CSD,Pepsi,Pull-Non-Working,Package Design,Package development,0,0,0,0,0,0,0
LAB North,El Salvador,2025,CSD,Pepsi,STB - Push,Capability Building/Other,Capability Building Other,50,166747,83373,83374,166747,83373,83374
LAB North,El Salvador,2025,CSD,Pepsi,STB - Push,Other Investments,CDA's,50,1576888,788444,788444,1576888,788444,788444
LAB North,El Salvador,2025,CSD,Pepsi,STB - Push,Other Investments,Capital (Coolers),0,0,0,0,0,0,0
LAB North,El Salvador,2025,CSD,Pepsi,STB - Push,Other Investments,Price Support,0,0,0,0,0,0,0
LAB North,El Salvador,2025,CSD,Pepsi,STB - Push,Other Investments,Vending / Racks,0,0,0,0,0,0,0
LAB North,El Salvador,2025,CSD,Pepsi,STB - Push,Other Trade,Frozen Funds,0,0,0,0,0,0,0
LAB North,El Salvador,2025,CSD,Pepsi,STB - Push,Other Trade,Other Trade,0,0,0,0,0,0,0
LAB North,El Salvador,2025,CSD,Pepsi,STB - Push,Trade Equipment,Coolers - New,0,0,0,0,0,0,0
LAB North,El Salvador,2025,CSD,Pepsi,STB - Push,Trade Equipment,Coolers - Refurbished,0,0,0,0,0,0,0
LAB North,El Salvador,2025,CSD,Pepsi,STB - Push,Trade Equipment,Post Mix / Pre Mix Equip.,0,0,0,0,0,0,0
LAB North,El Salvador,2025,CSD,Pepsi,STB - Push,Trade Equipment,Vending / Racks,0,0,0,0,0,0,0
LAB North,El Salvador,2025,CSD,Pepsi,STB - Push,Trade Programs,Distribution Incentives,0,0,0,0,0,0,0
LAB North,El Salvador,2025,CSD,Pepsi,STB - Push,Trade Programs,Innovation Investments,0,0,0,0,0,0,0
LAB North,El Salvador,2025,CSD,Pepsi,STB - Push,Trade Programs,Sales Incentives,0,0,0,0,0,0,0
LAB North,El Salvador,2025,CSD,Pepsi,STB - Push,Trade Programs,Space Investments,50,5154384,2577192,2577192,5154384,2577192,2577192
LAB North,El Salvador,2025,CSD,Pepsi,Pull-Working,All Other Working,Other Working - PR execution,0,0,0,0,0,0,0
LAB North,El Salvador,2025,CSD,Pepsi,Pull-Working,All Other Working,Other Working - activation,50,509999,254999,255000,509999,254999,255000
LAB North,El Salvador,2025,CSD,Pepsi,Pull-Working,All Other Working,Other Working - non allocated working,0,0,0,0,0,0,0
LAB North,El Salvador,2025,CSD,Pepsi,Pull-Working,Consumer Promotions,Consumer Promotions Execution,50,75457,37728,37729,75457,37728,37729
LAB North,El Salvador,2025,CSD,Pepsi,Pull-Working,Consumer Promotions,Coupons,50,627499,313749,313750,627499,313749,313750
LAB North,El Salvador,2025,CSD,Pepsi,Pull-Working,Consumer Promotions,Other,0,0,0,0,0,0,0
LAB North,El Salvador,2025,CSD,Pepsi,Pull-Working,Consumer Promotions,Premiums,0,0,0,0,0,0,0
LAB North,El Salvador,2025,CSD,Pepsi,Pull-Working,In Store & POS Execution,In-Store & POS Execution,50,554718,277359,277359,554718,277359,277359
LAB North,El Salvador,2025,CSD,Pepsi,Pull-Working,Media Placements,Cinema,0,0,0,0,0,0,0
LAB North,El Salvador,2025,CSD,Pepsi,Pull-Working,Media Placements,Digital,50,1054399,527199,527200,1054399,527199,527200
LAB North,El Salvador,2025,CSD,Pepsi,Pull-Working,Media Placements,OOH - Out Of Home,50,464999,232499,232500,464999,232499,232500
LAB North,El Salvador,2025,CSD,Pepsi,Pull-Working,Media Placements,Other,0,0,0,0,0,0,0
LAB North,El Salvador,2025,CSD,Pepsi,Pull-Working,Media Placements,Print,0,0,0,0,0,0,0
LAB North,El Salvador,2025,CSD,Pepsi,Pull-Working,Media Placements,Radio,50,19999,9999,10000,19999,9999,10000
LAB North,El Salvador,2025,CSD,Pepsi,Pull-Working,Media Placements,TV,50,495000,247500,247500,495000,247500,247500
LAB North,El Salvador,2025,CSD,Pepsi,Pull-Working,Sampling,Product Samples,0,0,0,0,0,0,0
LAB North,El Salvador,2025,CSD,Pepsi,Pull-Working,Sampling,Sampling Execution,0,0,0,0,0,0,0
LAB North,El Salvador,2025,CSD,Pepsi,Pull-Working,Sponsorships,Sponsorships-in game/ in show,0,0,0,0,0,0,0
LAB North,El Salvador,2025,CSD,Pepsi,Pull-Working,Sponsorships,Sports-athlete/team contracts,0,0,0,0,0,0,0
LAB North,El Salvador,2025,CSD,Pepsi,Pull-Working,Sponsorships,Sports-on field or in show props,0,0,0,0,0,0,0
LAB North,El Salvador,2025,CSD,Pepsi,Pull-Working,Sponsorships,Sports-stadium contracts,0,0,0,0,0,0,0
LAB North,Guatemala,2025,Energy Drinks,AMP,Pull-Non-Working,Ad Production,Digital Ad Production,0,0,0,0,0,0,0
LAB North,Guatemala,2025,Energy Drinks,AMP,Pull-Non-Working,Ad Production,"TV, Print, Radio, OOH, Production",50,199999,99999,100000,25911,12955,12956
LAB North,Guatemala,2025,Energy Drinks,AMP,Pull-Non-Working,Agency Fees,Creative Agency Fees,0,0,0,0,0,0,0
LAB North,Guatemala,2025,Energy Drinks,AMP,Pull-Non-Working,Agency Fees,In Store & POS Design / Development,0,0,0,0,0,0,0
LAB North,Guatemala,2025,Energy Drinks,AMP,Pull-Non-Working,Agency Fees,Media Agency Fees,0,0,0,0,0,0,0
LAB North,Guatemala,2025,Energy Drinks,AMP,Pull-Non-Working,Agency Fees,Other,0,0,0,0,0,0,0
LAB North,Guatemala,2025,Energy Drinks,AMP,Pull-Non-Working,Agency Fees,Social Media / Influence Marketing,0,0,0,0,0,0,0
LAB North,Guatemala,2025,Energy Drinks,AMP,Pull-Non-Working,All Other Non-Working,Administrative fees,0,0,0,0,0,0,0
LAB North,Guatemala,2025,Energy Drinks,AMP,Pull-Non-Working,All Other Non-Working,Agency out of pocket,0,0,0,0,0,0,0
LAB North,Guatemala,2025,Energy Drinks,AMP,Pull-Non-Working,All Other Non-Working,CP out of pocket admin,0,0,0,0,0,0,0
LAB North,Guatemala,2025,Energy Drinks,AMP,Pull-Non-Working,All Other Non-Working,Grassroots/experiential out of pocket,0,0,0,0,0,0,0
LAB North,Guatemala,2025,Energy Drinks,AMP,Pull-Non-Working,All Other Non-Working,League/property- rights fee/options,0,0,0,0,0,0,0
LAB North,Guatemala,2025,Energy Drinks,AMP,Pull-Non-Working,All Other Non-Working,Market Research,0,0,0,0,0,0,0
LAB North,Guatemala,2025,Energy Drinks,AMP,Pull-Non-Working,All Other Non-Working,Non-allocated NW,0,0,0,0,0,0,0
LAB North,Guatemala,2025,Energy Drinks,AMP,Pull-Non-Working,All Other Non-Working,Other Non Working-non itemised talent,0,0,0,0,0,0,0
LAB North,Guatemala,2025,Energy Drinks,AMP,Pull-Non-Working,All Other Non-Working,PR out of pocket administrative,0,0,0,0,0,0,0
LAB North,Guatemala,2025,Energy Drinks,AMP,Pull-Non-Working,Innovation and Insight,Innovations,0,0,0,0,0,0,0
LAB North,Guatemala,2025,Energy Drinks,AMP,Pull-Non-Working,Innovation and Insight,Market Research,50,499999,249999,250000,64778,32389,32389
LAB North,Guatemala,2025,Energy Drinks,AMP,Pull-Non-Working,Package Design,Package design,0,0,0,0,0,0,0
LAB North,Guatemala,2025,Energy Drinks,AMP,Pull-Non-Working,Package Design,Package development,0,0,0,0,0,0,0
LAB North,Guatemala,2025,Energy Drinks,AMP,STB - Push,Capability Building/Other,Capability Building Other,0,0,0,0,0,0,0
LAB North,Guatemala,2025,Energy Drinks,AMP,STB - Push,Other Investments,CDA's,0,0,0,0,0,0,0
LAB North,Guatemala,2025,Energy Drinks,AMP,STB - Push,Other Investments,Capital (Coolers),0,0,0,0,0,0,0
LAB North,Guatemala,2025,Energy Drinks,AMP,STB - Push,Other Investments,Price Support,50,11000000,5500000,5500000,1425131,712565,712566
LAB North,Guatemala,2025,Energy Drinks,AMP,STB - Push,Other Investments,Vending / Racks,0,0,0,0,0,0,0
LAB North,Guatemala,2025,Energy Drinks,AMP,STB - Push,Other Trade,Frozen Funds,0,0,0,0,0,0,0
LAB North,Guatemala,2025,Energy Drinks,AMP,STB - Push,Other Trade,Other Trade,0,0,0,0,0,0,0
LAB North,Guatemala,2025,Energy Drinks,AMP,STB - Push,Trade Equipment,Coolers - New,50,2294774,1147387,1147387,297305,148652,148653
LAB North,Guatemala,2025,Energy Drinks,AMP,STB - Push,Trade Equipment,Coolers - Refurbished,50,285640,142820,142820,37006,18503,18503
LAB North,Guatemala,2025,Energy Drinks,AMP,STB - Push,Trade Equipment,Post Mix / Pre Mix Equip.,0,0,0,0,0,0,0
LAB North,Guatemala,2025,Energy Drinks,AMP,STB - Push,Trade Equipment,Vending / Racks,50,299999,149999,150000,38867,19433,19434
LAB North,Guatemala,2025,Energy Drinks,AMP,STB - Push,Trade Programs,Distribution Incentives,50,149999,74999,75000,19433,9716,9717
LAB North,Guatemala,2025,Energy Drinks,AMP,STB - Push,Trade Programs,Innovation Investments,0,0,0,0,0,0,0
LAB North,Guatemala,2025,Energy Drinks,AMP,STB - Push,Trade Programs,Sales Incentives,50,9999,4999,5000,1295,647,648
LAB North,Guatemala,2025,Energy Drinks,AMP,STB - Push,Trade Programs,Space Investments,50,700000,350000,350000,90690,45345,45345
LAB North,Guatemala,2025,Energy Drinks,AMP,Pull-Working,All Other Working,Other Working - PR execution,0,0,0,0,0,0,0
LAB North,Guatemala,2025,Energy Drinks,AMP,Pull-Working,All Other Working,Other Working - activation,0,0,0,0,0,0,0
LAB North,Guatemala,2025,Energy Drinks,AMP,Pull-Working,All Other Working,Other Working - non allocated working,0,0,0,0,0,0,0
LAB North,Guatemala,2025,Energy Drinks,AMP,Pull-Working,Consumer Promotions,Consumer Promotions Execution,50,365856,182928,182928,47399,23699,23700
LAB North,Guatemala,2025,Energy Drinks,AMP,Pull-Working,Consumer Promotions,Coupons,0,0,0,0,0,0,0
LAB North,Guatemala,2025,Energy Drinks,AMP,Pull-Working,Consumer Promotions,Other,0,0,0,0,0,0,0
LAB North,Guatemala,2025,Energy Drinks,AMP,Pull-Working,Consumer Promotions,Premiums,50,49457,24728,24729,6407,3203,3204
LAB North,Guatemala,2025,Energy Drinks,AMP,Pull-Working,In Store & POS Execution,In-Store & POS Execution,50,1242167,621083,621084,160931,80465,80466
LAB North,Guatemala,2025,Energy Drinks,AMP,Pull-Working,Media Placements,Cinema,0,0,0,0,0,0,0
LAB North,Guatemala,2025,Energy Drinks,AMP,Pull-Working,Media Placements,Digital,50,934300,467150,467150,121045,60522,60523
LAB North,Guatemala,2025,Energy Drinks,AMP,Pull-Working,Media Placements,OOH - Out Of Home,50,1092225,546112,546113,141505,70752,70753
LAB North,Guatemala,2025,Energy Drinks,AMP,Pull-Working,Media Placements,Other,0,0,0,0,0,0,0
LAB North,Guatemala,2025,Energy Drinks,AMP,Pull-Working,Media Placements,Print,50,48649,24324,24325,6302,3151,3151
LAB North,Guatemala,2025,Energy Drinks,AMP,Pull-Working,Media Placements,Radio,50,573175,286587,286588,74259,37129,37130
LAB North,Guatemala,2025,Energy Drinks,AMP,Pull-Working,Media Placements,TV,50,993024,496512,496512,128653,64326,64327
LAB North,Guatemala,2025,Energy Drinks,AMP,Pull-Working,Sampling,Product Samples,0,0,0,0,0,0,0
LAB North,Guatemala,2025,Energy Drinks,AMP,Pull-Working,Sampling,Sampling Execution,0,0,0,0,0,0,0
LAB North,Guatemala,2025,Energy Drinks,AMP,Pull-Working,Sponsorships,Sponsorships-in game/ in show,50,128725,64362,64363,16677,8338,8339
LAB North,Guatemala,2025,Energy Drinks,AMP,Pull-Working,Sponsorships,Sports-athlete/team contracts,0,0,0,0,0,0,0
LAB North,Guatemala,2025,Energy Drinks,AMP,Pull-Working,Sponsorships,Sports-on field or in show props,0,0,0,0,0,0,0
LAB North,Guatemala,2025,Energy Drinks,AMP,Pull-Working,Sponsorships,Sports-stadium contracts,0,0,0,0,0,0,0
LAB North,Guatemala,2025,Energy Drinks,Adrenaline,Pull-Non-Working,Ad Production,Digital Ad Production,0,0,0,0,0,0,0
LAB North,Guatemala,2025,Energy Drinks,Adrenaline,Pull-Non-Working,Ad Production,"TV, Print, Radio, OOH, Production",50,513476,256738,256738,66524,33262,33262
LAB North,Guatemala,2025,Energy Drinks,Adrenaline,Pull-Non-Working,Agency Fees,Creative Agency Fees,0,0,0,0,0,0,0
LAB North,Guatemala,2025,Energy Drinks,Adrenaline,Pull-Non-Working,Agency Fees,In Store & POS Design / Development,0,0,0,0,0,0,0
LAB North,Guatemala,2025,Energy Drinks,Adrenaline,Pull-Non-Working,Agency Fees,Media Agency Fees,0,0,0,0,0,0,0
LAB North,Guatemala,2025,Energy Drinks,Adrenaline,Pull-Non-Working,Agency Fees,Other,0,0,0,0,0,0,0
LAB North,Guatemala,2025,Energy Drinks,Adrenaline,Pull-Non-Working,Agency Fees,Social Media / Influence Marketing,0,0,0,0,0,0,0
LAB North,Guatemala,2025,Energy Drinks,Adrenaline,Pull-Non-Working,All Other Non-Working,Administrative fees,0,0,0,0,0,0,0
LAB North,Guatemala,2025,Energy Drinks,Adrenaline,Pull-Non-Working,All Other Non-Working,Agency out of pocket,0,0,0,0,0,0,0
LAB North,Guatemala,2025,Energy Drinks,Adrenaline,Pull-Non-Working,All Other Non-Working,CP out of pocket admin,0,0,0,0,0,0,0
LAB North,Guatemala,2025,Energy Drinks,Adrenaline,Pull-Non-Working,All Other Non-Working,Grassroots/experiential out of pocket,0,0,0,0,0,0,0
LAB North,Guatemala,2025,Energy Drinks,Adrenaline,Pull-Non-Working,All Other Non-Working,League/property- rights fee/options,0,0,0,0,0,0,0
LAB North,Guatemala,2025,Energy Drinks,Adrenaline,Pull-Non-Working,All Other Non-Working,Market Research,0,0,0,0,0,0,0
LAB North,Guatemala,2025,Energy Drinks,Adrenaline,Pull-Non-Working,All Other Non-Working,Non-allocated NW,0,0,0,0,0,0,0
LAB North,Guatemala,2025,Energy Drinks,Adrenaline,Pull-Non-Working,All Other Non-Working,Other Non Working-non itemised talent,0,0,0,0,0,0,0
LAB North,Guatemala,2025,Energy Drinks,Adrenaline,Pull-Non-Working,All Other Non-Working,PR out of pocket administrative,0,0,0,0,0,0,0
LAB North,Guatemala,2025,Energy Drinks,Adrenaline,Pull-Non-Working,Innovation and Insight,Innovations,0,0,0,0,0,0,0
LAB North,Guatemala,2025,Energy Drinks,Adrenaline,Pull-Non-Working,Innovation and Insight,Market Research,50,506576,253288,253288,65630,32815,32815
LAB North,Guatemala,2025,Energy Drinks,Adrenaline,Pull-Non-Working,Package Design,Package design,0,0,0,0,0,0,0
LAB North,Guatemala,2025,Energy Drinks,Adrenaline,Pull-Non-Working,Package Design,Package development,0,0,0,0,0,0,0
LAB North,Guatemala,2025,Energy Drinks,Adrenaline,STB - Push,Capability Building/Other,Capability Building Other,0,0,0,0,0,0,0
LAB North,Guatemala,2025,Energy Drinks,Adrenaline,STB - Push,Other Investments,CDA's,0,0,0,0,0,0,0
LAB North,Guatemala,2025,Energy Drinks,Adrenaline,STB - Push,Other Investments,Capital (Coolers),0,0,0,0,0,0,0
LAB North,Guatemala,2025,Energy Drinks,Adrenaline,STB - Push,Other Investments,Price Support,50,26999999,13499999,13500000,3498050,1749025,1749025
LAB North,Guatemala,2025,Energy Drinks,Adrenaline,STB - Push,Other Investments,Vending / Racks,0,0,0,0,0,0,0
LAB North,Guatemala,2025,Energy Drinks,Adrenaline,STB - Push,Other Trade,Frozen Funds,0,0,0,0,0,0,0
LAB North,Guatemala,2025,Energy Drinks,Adrenaline,STB - Push,Other Trade,Other Trade,0,0,0,0,0,0,0
LAB North,Guatemala,2025,Energy Drinks,Adrenaline,STB - Push,Trade Equipment,Coolers - New,50,9944025,4972012,4972013,1288322,644161,644161
LAB North,Guatemala,2025,Energy Drinks,Adrenaline,STB - Push,Trade Equipment,Coolers - Refurbished,50,1237775,618887,618888,160362,80181,80181
LAB North,Guatemala,2025,Energy Drinks,Adrenaline,STB - Push,Trade Equipment,Post Mix / Pre Mix Equip.,0,0,0,0,0,0,0
LAB North,Guatemala,2025,Energy Drinks,Adrenaline,STB - Push,Trade Equipment,Vending / Racks,50,299999,149999,150000,38867,19433,19434
LAB North,Guatemala,2025,Energy Drinks,Adrenaline,STB - Push,Trade Programs,Distribution Incentives,50,350000,175000,175000,45345,22672,22673
LAB North,Guatemala,2025,Energy Drinks,Adrenaline,STB - Push,Trade Programs,Innovation Investments,0,0,0,0,0,0,0
LAB North,Guatemala,2025,Energy Drinks,Adrenaline,STB - Push,Trade Programs,Sales Incentives,50,20000,10000,10000,2591,1295,1296
LAB North,Guatemala,2025,Energy Drinks,Adrenaline,STB - Push,Trade Programs,Space Investments,50,500000,250000,250000,64778,32389,32389
LAB North,Guatemala,2025,Energy Drinks,Adrenaline,Pull-Working,All Other Working,Other Working - PR execution,0,0,0,0,0,0,0
LAB North,Guatemala,2025,Energy Drinks,Adrenaline,Pull-Working,All Other Working,Other Working - activation,0,0,0,0,0,0,0
LAB North,Guatemala,2025,Energy Drinks,Adrenaline,Pull-Working,All Other Working,Other Working - non allocated working,0,0,0,0,0,0,0
LAB North,Guatemala,2025,Energy Drinks,Adrenaline,Pull-Working,Consumer Promotions,Consumer Promotions Execution,50,999999,499999,500000,129557,64778,64779
LAB North,Guatemala,2025,Energy Drinks,Adrenaline,Pull-Working,Consumer Promotions,Coupons,0,0,0,0,0,0,0
LAB North,Guatemala,2025,Energy Drinks,Adrenaline,Pull-Working,Consumer Promotions,Other,0,0,0,0,0,0,0
LAB North,Guatemala,2025,Energy Drinks,Adrenaline,Pull-Working,Consumer Promotions,Premiums,50,24999,12499,12500,3238,1619,1619
LAB North,Guatemala,2025,Energy Drinks,Adrenaline,Pull-Working,In Store & POS Execution,In-Store & POS Execution,50,1262806,631403,631403,163605,81802,81803
LAB North,Guatemala,2025,Energy Drinks,Adrenaline,Pull-Working,Media Placements,Cinema,0,0,0,0,0,0,0
LAB North,Guatemala,2025,Energy Drinks,Adrenaline,Pull-Working,Media Placements,Digital,50,572171,286085,286086,74129,37064,37065
LAB North,Guatemala,2025,Energy Drinks,Adrenaline,Pull-Working,Media Placements,OOH - Out Of Home,50,157000,78500,78500,20340,10170,10170
LAB North,Guatemala,2025,Energy Drinks,Adrenaline,Pull-Working,Media Placements,Other,0,0,0,0,0,0,0
LAB North,Guatemala,2025,Energy Drinks,Adrenaline,Pull-Working,Media Placements,Print,0,0,0,0,0,0,0
LAB North,Guatemala,2025,Energy Drinks,Adrenaline,Pull-Working,Media Placements,Radio,0,0,0,0,0,0,0
LAB North,Guatemala,2025,Energy Drinks,Adrenaline,Pull-Working,Media Placements,TV,0,0,0,0,0,0,0
LAB North,Guatemala,2025,Energy Drinks,Adrenaline,Pull-Working,Sampling,Product Samples,0,0,0,0,0,0,0
LAB North,Guatemala,2025,Energy Drinks,Adrenaline,Pull-Working,Sampling,Sampling Execution,0,0,0,0,0,0,0
LAB North,Guatemala,2025,Energy Drinks,Adrenaline,Pull-Working,Sponsorships,Sponsorships-in game/ in show,50,179411,89705,89706,23244,11621,11623
LAB North,Guatemala,2025,Energy Drinks,Adrenaline,Pull-Working,Sponsorships,Sports-athlete/team contracts,50,24999,12499,12500,3238,1619,1619
LAB North,Guatemala,2025,Energy Drinks,Adrenaline,Pull-Working,Sponsorships,Sports-on field or in show props,0,0,0,0,0,0,0
LAB North,Guatemala,2025,Energy Drinks,Adrenaline,Pull-Working,Sponsorships,Sports-stadium contracts,0,0,0,0,0,0,0
LAB North,Guatemala,2025,Sport Drinks,Gatorade,Pull-Non-Working,Ad Production,Digital Ad Production,0,0,0,0,0,0,0
LAB North,Guatemala,2025,Sport Drinks,Gatorade,Pull-Non-Working,Ad Production,"TV, Print, Radio, OOH, Production",50,615936,307968,307968,79799,39899,39900
LAB North,Guatemala,2025,Sport Drinks,Gatorade,Pull-Non-Working,Agency Fees,Creative Agency Fees,0,0,0,0,0,0,0
LAB North,Guatemala,2025,Sport Drinks,Gatorade,Pull-Non-Working,Agency Fees,In Store & POS Design / Development,0,0,0,0,0,0,0
LAB North,Guatemala,2025,Sport Drinks,Gatorade,Pull-Non-Working,Agency Fees,Media Agency Fees,0,0,0,0,0,0,0
LAB North,Guatemala,2025,Sport Drinks,Gatorade,Pull-Non-Working,Agency Fees,Other,0,0,0,0,0,0,0
LAB North,Guatemala,2025,Sport Drinks,Gatorade,Pull-Non-Working,Agency Fees,Social Media / Influence Marketing,0,0,0,0,0,0,0
LAB North,Guatemala,2025,Sport Drinks,Gatorade,Pull-Non-Working,All Other Non-Working,Administrative fees,0,0,0,0,0,0,0
LAB North,Guatemala,2025,Sport Drinks,Gatorade,Pull-Non-Working,All Other Non-Working,Agency out of pocket,0,0,0,0,0,0,0
LAB North,Guatemala,2025,Sport Drinks,Gatorade,Pull-Non-Working,All Other Non-Working,CP out of pocket admin,0,0,0,0,0,0,0
LAB North,Guatemala,2025,Sport Drinks,Gatorade,Pull-Non-Working,All Other Non-Working,Grassroots/experiential out of pocket,0,0,0,0,0,0,0
LAB North,Guatemala,2025,Sport Drinks,Gatorade,Pull-Non-Working,All Other Non-Working,League/property- rights fee/options,0,0,0,0,0,0,0
LAB North,Guatemala,2025,Sport Drinks,Gatorade,Pull-Non-Working,All Other Non-Working,Market Research,0,0,0,0,0,0,0
LAB North,Guatemala,2025,Sport Drinks,Gatorade,Pull-Non-Working,All Other Non-Working,Non-allocated NW,0,0,0,0,0,0,0
LAB North,Guatemala,2025,Sport Drinks,Gatorade,Pull-Non-Working,All Other Non-Working,Other Non Working-non itemised talent,0,0,0,0,0,0,0
LAB North,Guatemala,2025,Sport Drinks,Gatorade,Pull-Non-Working,All Other Non-Working,PR out of pocket administrative,0,0,0,0,0,0,0
LAB North,Guatemala,2025,Sport Drinks,Gatorade,Pull-Non-Working,Innovation and Insight,Innovations,0,0,0,0,0,0,0
LAB North,Guatemala,2025,Sport Drinks,Gatorade,Pull-Non-Working,Innovation and Insight,Market Research,50,976462,488231,488231,126507,63253,63254
LAB North,Guatemala,2025,Sport Drinks,Gatorade,Pull-Non-Working,Package Design,Package design,0,0,0,0,0,0,0
LAB North,Guatemala,2025,Sport Drinks,Gatorade,Pull-Non-Working,Package Design,Package development,0,0,0,0,0,0,0
LAB North,Guatemala,2025,Sport Drinks,Gatorade,STB - Push,Capability Building/Other,Capability Building Other,0,0,0,0,0,0,0
LAB North,Guatemala,2025,Sport Drinks,Gatorade,STB - Push,Other Investments,CDA's,50,1218762,609381,609381,157899,78949,78950
LAB North,Guatemala,2025,Sport Drinks,Gatorade,STB - Push,Other Investments,Capital (Coolers),0,0,0,0,0,0,0
LAB North,Guatemala,2025,Sport Drinks,Gatorade,STB - Push,Other Investments,Price Support,50,16000000,8000000,8000000,2072919,1036459,1036460
LAB North,Guatemala,2025,Sport Drinks,Gatorade,STB - Push,Other Investments,Vending / Racks,0,0,0,0,0,0,0
LAB North,Guatemala,2025,Sport Drinks,Gatorade,STB - Push,Other Trade,Frozen Funds,0,0,0,0,0,0,0
LAB North,Guatemala,2025,Sport Drinks,Gatorade,STB - Push,Other Trade,Other Trade,0,0,0,0,0,0,0
LAB North,Guatemala,2025,Sport Drinks,Gatorade,STB - Push,Trade Equipment,Coolers - New,50,19123124,9561562,9561562,2477543,1238771,1238772
LAB North,Guatemala,2025,Sport Drinks,Gatorade,STB - Push,Trade Equipment,Coolers - Refurbished,50,2380338,1190169,1190169,308390,154195,154195
LAB North,Guatemala,2025,Sport Drinks,Gatorade,STB - Push,Trade Equipment,Post Mix / Pre Mix Equip.,0,0,0,0,0,0,0
LAB North,Guatemala,2025,Sport Drinks,Gatorade,STB - Push,Trade Equipment,Vending / Racks,50,300000,150000,150000,38867,19433,19434
LAB North,Guatemala,2025,Sport Drinks,Gatorade,STB - Push,Trade Programs,Distribution Incentives,50,799999,399999,400000,103645,51822,51823
LAB North,Guatemala,2025,Sport Drinks,Gatorade,STB - Push,Trade Programs,Innovation Investments,0,0,0,0,0,0,0
LAB North,Guatemala,2025,Sport Drinks,Gatorade,STB - Push,Trade Programs,Sales Incentives,50,122192,61096,61096,15830,7915,7915
LAB North,Guatemala,2025,Sport Drinks,Gatorade,STB - Push,Trade Programs,Space Investments,50,1827412,913706,913706,236754,118377,118377
LAB North,Guatemala,2025,Sport Drinks,Gatorade,Pull-Working,All Other Working,Other Working - PR execution,0,0,0,0,0,0,0
LAB North,Guatemala,2025,Sport Drinks,Gatorade,Pull-Working,All Other Working,Other Working - activation,0,0,0,0,0,0,0
LAB North,Guatemala,2025,Sport Drinks,Gatorade,Pull-Working,All Other Working,Other Working - non allocated working,0,0,0,0,0,0,0
LAB North,Guatemala,2025,Sport Drinks,Gatorade,Pull-Working,Consumer Promotions,Consumer Promotions Execution,50,4282226,2141113,2141113,554794,277397,277397
LAB North,Guatemala,2025,Sport Drinks,Gatorade,Pull-Working,Consumer Promotions,Coupons,0,0,0,0,0,0,0
LAB North,Guatemala,2025,Sport Drinks,Gatorade,Pull-Working,Consumer Promotions,Other,0,0,0,0,0,0,0
LAB North,Guatemala,2025,Sport Drinks,Gatorade,Pull-Working,Consumer Promotions,Premiums,50,254830,127415,127415,33015,16507,16508
LAB North,Guatemala,2025,Sport Drinks,Gatorade,Pull-Working,In Store & POS Execution,In-Store & POS Execution,50,4448881,2224440,2224441,576385,288192,288193
LAB North,Guatemala,2025,Sport Drinks,Gatorade,Pull-Working,Media Placements,Cinema,0,0,0,0,0,0,0
LAB North,Guatemala,2025,Sport Drinks,Gatorade,Pull-Working,Media Placements,Digital,50,1009940,504970,504970,130845,65422,65423
LAB North,Guatemala,2025,Sport Drinks,Gatorade,Pull-Working,Media Placements,OOH - Out Of Home,0,0,0,0,0,0,0
LAB North,Guatemala,2025,Sport Drinks,Gatorade,Pull-Working,Media Placements,Other,0,0,0,0,0,0,0
LAB North,Guatemala,2025,Sport Drinks,Gatorade,Pull-Working,Media Placements,Print,0,0,0,0,0,0,0
LAB North,Guatemala,2025,Sport Drinks,Gatorade,Pull-Working,Media Placements,Radio,0,0,0,0,0,0,0
LAB North,Guatemala,2025,Sport Drinks,Gatorade,Pull-Working,Media Placements,TV,0,0,0,0,0,0,0
LAB North,Guatemala,2025,Sport Drinks,Gatorade,Pull-Working,Sampling,Product Samples,0,0,0,0,0,0,0
LAB North,Guatemala,2025,Sport Drinks,Gatorade,Pull-Working,Sampling,Sampling Execution,50,575033,287516,287517,74499,37249,37250
LAB North,Guatemala,2025,Sport Drinks,Gatorade,Pull-Working,Sponsorships,Sponsorships-in game/ in show,50,1468360,734180,734180,190236,95118,95118
LAB North,Guatemala,2025,Sport Drinks,Gatorade,Pull-Working,Sponsorships,Sports-athlete/team contracts,50,1214496,607248,607248,157346,78673,78673
LAB North,Guatemala,2025,Sport Drinks,Gatorade,Pull-Working,Sponsorships,Sports-on field or in show props,0,0,0,0,0,0,0
LAB North,Guatemala,2025,Sport Drinks,Gatorade,Pull-Working,Sponsorships,Sports-stadium contracts,0,0,0,0,0,0,0
LAB North,Guatemala,2025,RTD Tea,Lipton,Pull-Non-Working,Ad Production,Digital Ad Production,0,0,0,0,0,0,0
LAB North,Guatemala,2025,RTD Tea,Lipton,Pull-Non-Working,Ad Production,"TV, Print, Radio, OOH, Production",50,109790,54895,54895,14224,7112,7112
LAB North,Guatemala,2025,RTD Tea,Lipton,Pull-Non-Working,Agency Fees,Creative Agency Fees,0,0,0,0,0,0,0
LAB North,Guatemala,2025,RTD Tea,Lipton,Pull-Non-Working,Agency Fees,In Store & POS Design / Development,0,0,0,0,0,0,0
LAB North,Guatemala,2025,RTD Tea,Lipton,Pull-Non-Working,Agency Fees,Media Agency Fees,0,0,0,0,0,0,0
LAB North,Guatemala,2025,RTD Tea,Lipton,Pull-Non-Working,Agency Fees,Other,0,0,0,0,0,0,0
LAB North,Guatemala,2025,RTD Tea,Lipton,Pull-Non-Working,Agency Fees,Social Media / Influence Marketing,0,0,0,0,0,0,0
LAB North,Guatemala,2025,RTD Tea,Lipton,Pull-Non-Working,All Other Non-Working,Administrative fees,0,0,0,0,0,0,0
LAB North,Guatemala,2025,RTD Tea,Lipton,Pull-Non-Working,All Other Non-Working,Agency out of pocket,0,0,0,0,0,0,0
LAB North,Guatemala,2025,RTD Tea,Lipton,Pull-Non-Working,All Other Non-Working,CP out of pocket admin,0,0,0,0,0,0,0
LAB North,Guatemala,2025,RTD Tea,Lipton,Pull-Non-Working,All Other Non-Working,Grassroots/experiential out of pocket,0,0,0,0,0,0,0
LAB North,Guatemala,2025,RTD Tea,Lipton,Pull-Non-Working,All Other Non-Working,League/property- rights fee/options,0,0,0,0,0,0,0
LAB North,Guatemala,2025,RTD Tea,Lipton,Pull-Non-Working,All Other Non-Working,Market Research,0,0,0,0,0,0,0
LAB North,Guatemala,2025,RTD Tea,Lipton,Pull-Non-Working,All Other Non-Working,Non-allocated NW,0,0,0,0,0,0,0
LAB North,Guatemala,2025,RTD Tea,Lipton,Pull-Non-Working,All Other Non-Working,Other Non Working-non itemised talent,0,0,0,0,0,0,0
LAB North,Guatemala,2025,RTD Tea,Lipton,Pull-Non-Working,All Other Non-Working,PR out of pocket administrative,0,0,0,0,0,0,0
LAB North,Guatemala,2025,RTD Tea,Lipton,Pull-Non-Working,Innovation and Insight,Innovations,0,0,0,0,0,0,0
LAB North,Guatemala,2025,RTD Tea,Lipton,Pull-Non-Working,Innovation and Insight,Market Research,50,301182,150591,150591,39020,19510,19510
LAB North,Guatemala,2025,RTD Tea,Lipton,Pull-Non-Working,Package Design,Package design,0,0,0,0,0,0,0
LAB North,Guatemala,2025,RTD Tea,Lipton,Pull-Non-Working,Package Design,Package development,0,0,0,0,0,0,0
LAB North,Guatemala,2025,RTD Tea,Lipton,STB - Push,Capability Building/Other,Capability Building Other,0,0,0,0,0,0,0
LAB North,Guatemala,2025,RTD Tea,Lipton,STB - Push,Other Investments,CDA's,50,2132289,1066144,1066145,276253,138126,138127
LAB North,Guatemala,2025,RTD Tea,Lipton,STB - Push,Other Investments,Capital (Coolers),0,0,0,0,0,0,0
LAB North,Guatemala,2025,RTD Tea,Lipton,STB - Push,Other Investments,Price Support,50,3737567,1868783,1868784,484229,242114,242115
LAB North,Guatemala,2025,RTD Tea,Lipton,STB - Push,Other Investments,Vending / Racks,0,0,0,0,0,0,0
LAB North,Guatemala,2025,RTD Tea,Lipton,STB - Push,Other Trade,Frozen Funds,0,0,0,0,0,0,0
LAB North,Guatemala,2025,RTD Tea,Lipton,STB - Push,Other Trade,Other Trade,0,0,0,0,0,0,0
LAB North,Guatemala,2025,RTD Tea,Lipton,STB - Push,Trade Equipment,Coolers - New,50,4334575,2167287,2167288,561576,280788,280788
LAB North,Guatemala,2025,RTD Tea,Lipton,STB - Push,Trade Equipment,Coolers - Refurbished,50,539543,269771,269772,69901,34950,34951
LAB North,Guatemala,2025,RTD Tea,Lipton,STB - Push,Trade Equipment,Post Mix / Pre Mix Equip.,50,557714,278857,278857,72255,36127,36128
LAB North,Guatemala,2025,RTD Tea,Lipton,STB - Push,Trade Equipment,Vending / Racks,50,99999,49999,50000,12955,6477,6478
LAB North,Guatemala,2025,RTD Tea,Lipton,STB - Push,Trade Programs,Distribution Incentives,50,699999,349999,350000,90690,45344,45346
LAB North,Guatemala,2025,RTD Tea,Lipton,STB - Push,Trade Programs,Innovation Investments,0,0,0,0,0,0,0
LAB North,Guatemala,2025,RTD Tea,Lipton,STB - Push,Trade Programs,Sales Incentives,50,9999,4999,5000,1295,647,648
LAB North,Guatemala,2025,RTD Tea,Lipton,STB - Push,Trade Programs,Space Investments,50,689545,344772,344773,89335,44667,44668
LAB North,Guatemala,2025,RTD Tea,Lipton,Pull-Working,All Other Working,Other Working - PR execution,0,0,0,0,0,0,0
LAB North,Guatemala,2025,RTD Tea,Lipton,Pull-Working,All Other Working,Other Working - activation,0,0,0,0,0,0,0
LAB North,Guatemala,2025,RTD Tea,Lipton,Pull-Working,All Other Working,Other Working - non allocated working,0,0,0,0,0,0,0
LAB North,Guatemala,2025,RTD Tea,Lipton,Pull-Working,Consumer Promotions,Consumer Promotions Execution,50,2240358,1120179,1120179,290255,145127,145128
LAB North,Guatemala,2025,RTD Tea,Lipton,Pull-Working,Consumer Promotions,Coupons,0,0,0,0,0,0,0
LAB North,Guatemala,2025,RTD Tea,Lipton,Pull-Working,Consumer Promotions,Other,0,0,0,0,0,0,0
LAB North,Guatemala,2025,RTD Tea,Lipton,Pull-Working,Consumer Promotions,Premiums,0,0,0,0,0,0,0
LAB North,Guatemala,2025,RTD Tea,Lipton,Pull-Working,In Store & POS Execution,In-Store & POS Execution,50,6286523,3143261,3143262,814465,407232,407233
LAB North,Guatemala,2025,RTD Tea,Lipton,Pull-Working,Media Placements,Cinema,0,0,0,0,0,0,0
LAB North,Guatemala,2025,RTD Tea,Lipton,Pull-Working,Media Placements,Digital,50,623850,311925,311925,80824,40412,40412
LAB North,Guatemala,2025,RTD Tea,Lipton,Pull-Working,Media Placements,OOH - Out Of Home,0,0,0,0,0,0,0
LAB North,Guatemala,2025,RTD Tea,Lipton,Pull-Working,Media Placements,Other,0,0,0,0,0,0,0
LAB North,Guatemala,2025,RTD Tea,Lipton,Pull-Working,Media Placements,Print,0,0,0,0,0,0,0
LAB North,Guatemala,2025,RTD Tea,Lipton,Pull-Working,Media Placements,Radio,0,0,0,0,0,0,0
LAB North,Guatemala,2025,RTD Tea,Lipton,Pull-Working,Media Placements,TV,0,0,0,0,0,0,0
LAB North,Guatemala,2025,RTD Tea,Lipton,Pull-Working,Sampling,Product Samples,0,0,0,0,0,0,0
LAB North,Guatemala,2025,RTD Tea,Lipton,Pull-Working,Sampling,Sampling Execution,0,0,0,0,0,0,0
LAB North,Guatemala,2025,RTD Tea,Lipton,Pull-Working,Sponsorships,Sponsorships-in game/ in show,50,275196,137598,137598,35653,17826,17827
LAB North,Guatemala,2025,RTD Tea,Lipton,Pull-Working,Sponsorships,Sports-athlete/team contracts,0,0,0,0,0,0,0
LAB North,Guatemala,2025,RTD Tea,Lipton,Pull-Working,Sponsorships,Sports-on field or in show props,0,0,0,0,0,0,0
LAB North,Guatemala,2025,RTD Tea,Lipton,Pull-Working,Sponsorships,Sports-stadium contracts,0,0,0,0,0,0,0
LAB North,Guatemala,2025,CSD,Pepsi,Pull-Non-Working,Ad Production,Digital Ad Production,0,0,0,0,0,0,0
LAB North,Guatemala,2025,CSD,Pepsi,Pull-Non-Working,Ad Production,"TV, Print, Radio, OOH, Production",50,2419462,1209731,1209731,313459,156729,156730
LAB North,Guatemala,2025,CSD,Pepsi,Pull-Non-Working,Agency Fees,Creative Agency Fees,0,0,0,0,0,0,0
LAB North,Guatemala,2025,CSD,Pepsi,Pull-Non-Working,Agency Fees,In Store & POS Design / Development,0,0,0,0,0,0,0
LAB North,Guatemala,2025,CSD,Pepsi,Pull-Non-Working,Agency Fees,Media Agency Fees,0,0,0,0,0,0,0
LAB North,Guatemala,2025,CSD,Pepsi,Pull-Non-Working,Agency Fees,Other,0,0,0,0,0,0,0
LAB North,Guatemala,2025,CSD,Pepsi,Pull-Non-Working,Agency Fees,Social Media / Influence Marketing,0,0,0,0,0,0,0
LAB North,Guatemala,2025,CSD,Pepsi,Pull-Non-Working,All Other Non-Working,Administrative fees,0,0,0,0,0,0,0
LAB North,Guatemala,2025,CSD,Pepsi,Pull-Non-Working,All Other Non-Working,Agency out of pocket,0,0,0,0,0,0,0
LAB North,Guatemala,2025,CSD,Pepsi,Pull-Non-Working,All Other Non-Working,CP out of pocket admin,0,0,0,0,0,0,0
LAB North,Guatemala,2025,CSD,Pepsi,Pull-Non-Working,All Other Non-Working,Grassroots/experiential out of pocket,0,0,0,0,0,0,0
LAB North,Guatemala,2025,CSD,Pepsi,Pull-Non-Working,All Other Non-Working,League/property- rights fee/options,0,0,0,0,0,0,0
LAB North,Guatemala,2025,CSD,Pepsi,Pull-Non-Working,All Other Non-Working,Market Research,0,0,0,0,0,0,0
LAB North,Guatemala,2025,CSD,Pepsi,Pull-Non-Working,All Other Non-Working,Non-allocated NW,0,0,0,0,0,0,0
LAB North,Guatemala,2025,CSD,Pepsi,Pull-Non-Working,All Other Non-Working,Other Non Working-non itemised talent,0,0,0,0,0,0,0
LAB North,Guatemala,2025,CSD,Pepsi,Pull-Non-Working,All Other Non-Working,PR out of pocket administrative,0,0,0,0,0,0,0
LAB North,Guatemala,2025,CSD,Pepsi,Pull-Non-Working,Innovation and Insight,Innovations,0,0,0,0,0,0,0
LAB North,Guatemala,2025,CSD,Pepsi,Pull-Non-Working,Innovation and Insight,Market Research,50,1330023,665011,665012,172314,86157,86157
LAB North,Guatemala,2025,CSD,Pepsi,Pull-Non-Working,Package Design,Package design,0,0,0,0,0,0,0
LAB North,Guatemala,2025,CSD,Pepsi,Pull-Non-Working,Package Design,Package development,0,0,0,0,0,0,0
LAB North,Guatemala,2025,CSD,Pepsi,STB - Push,Capability Building/Other,Capability Building Other,0,0,0,0,0,0,0
LAB North,Guatemala,2025,CSD,Pepsi,STB - Push,Other Investments,CDA's,50,18888948,9444474,9444474,2447203,1223601,1223602
LAB North,Guatemala,2025,CSD,Pepsi,STB - Push,Other Investments,Capital (Coolers),0,0,0,0,0,0,0
LAB North,Guatemala,2025,CSD,Pepsi,STB - Push,Other Investments,Price Support,50,111750000,55875000,55875000,14478043,7239021,7239022
LAB North,Guatemala,2025,CSD,Pepsi,STB - Push,Other Investments,Vending / Racks,0,0,0,0,0,0,0
LAB North,Guatemala,2025,CSD,Pepsi,STB - Push,Other Trade,Frozen Funds,0,0,0,0,0,0,0
LAB North,Guatemala,2025,CSD,Pepsi,STB - Push,Other Trade,Other Trade,0,0,0,0,0,0,0
LAB North,Guatemala,2025,CSD,Pepsi,STB - Push,Trade Equipment,Coolers - New,50,15298500,7649250,7649250,1982034,991017,991017
LAB North,Guatemala,2025,CSD,Pepsi,STB - Push,Trade Equipment,Coolers - Refurbished,50,1904270,952135,952135,246712,123356,123356
LAB North,Guatemala,2025,CSD,Pepsi,STB - Push,Trade Equipment,Post Mix / Pre Mix Equip.,50,4109473,2054736,2054737,532412,266206,266206
LAB North,Guatemala,2025,CSD,Pepsi,STB - Push,Trade Equipment,Vending / Racks,50,2635329,1317664,1317665,341426,170713,170713
LAB North,Guatemala,2025,CSD,Pepsi,STB - Push,Trade Programs,Distribution Incentives,50,4871049,2435524,2435525,631080,315540,315540
LAB North,Guatemala,2025,CSD,Pepsi,STB - Push,Trade Programs,Innovation Investments,0,0,0,0,0,0,0
LAB North,Guatemala,2025,CSD,Pepsi,STB - Push,Trade Programs,Sales Incentives,50,9769926,4884963,4884963,1265766,632883,632883
LAB North,Guatemala,2025,CSD,Pepsi,STB - Push,Trade Programs,Space Investments,50,18478781,9239390,9239391,2394063,1197031,1197032
LAB North,Guatemala,2025,CSD,Pepsi,Pull-Working,All Other Working,Other Working - PR execution,0,0,0,0,0,0,0
LAB North,Guatemala,2025,CSD,Pepsi,Pull-Working,All Other Working,Other Working - activation,0,0,0,0,0,0,0
LAB North,Guatemala,2025,CSD,Pepsi,Pull-Working,All Other Working,Other Working - non allocated working,0,0,0,0,0,0,0
LAB North,Guatemala,2025,CSD,Pepsi,Pull-Working,Consumer Promotions,Consumer Promotions Execution,50,87724107,43862053,43862054,11365310,5682655,5682655
LAB North,Guatemala,2025,CSD,Pepsi,Pull-Working,Consumer Promotions,Coupons,0,0,0,0,0,0,0
LAB North,Guatemala,2025,CSD,Pepsi,Pull-Working,Consumer Promotions,Other,0,0,0,0,0,0,0
LAB North,Guatemala,2025,CSD,Pepsi,Pull-Working,Consumer Promotions,Premiums,50,1602608,801304,801304,207629,103814,103815
LAB North,Guatemala,2025,CSD,Pepsi,Pull-Working,In Store & POS Execution,In-Store & POS Execution,50,7741730,3870865,3870865,1002998,501499,501499
LAB North,Guatemala,2025,CSD,Pepsi,Pull-Working,Media Placements,Cinema,0,0,0,0,0,0,0
LAB North,Guatemala,2025,CSD,Pepsi,Pull-Working,Media Placements,Digital,50,4063947,2031973,2031974,526514,263257,263257
LAB North,Guatemala,2025,CSD,Pepsi,Pull-Working,Media Placements,OOH - Out Of Home,50,2869999,1434999,1435000,371829,185914,185915
LAB North,Guatemala,2025,CSD,Pepsi,Pull-Working,Media Placements,Other,0,0,0,0,0,0,0
LAB North,Guatemala,2025,CSD,Pepsi,Pull-Working,Media Placements,Print,50,125000,62500,62500,16194,8097,8097
LAB North,Guatemala,2025,CSD,Pepsi,Pull-Working,Media Placements,Radio,50,1049999,524999,525000,136035,68017,68018
LAB North,Guatemala,2025,CSD,Pepsi,Pull-Working,Media Placements,TV,50,2859998,1429999,1429999,370534,185267,185267
LAB North,Guatemala,2025,CSD,Pepsi,Pull-Working,Sampling,Product Samples,0,0,0,0,0,0,0
LAB North,Guatemala,2025,CSD,Pepsi,Pull-Working,Sampling,Sampling Execution,50,5299850,2649925,2649925,686635,343317,343318
LAB North,Guatemala,2025,CSD,Pepsi,Pull-Working,Sponsorships,Sponsorships-in game/ in show,50,24002577,12001288,12001289,3109712,1554856,1554856
LAB North,Guatemala,2025,CSD,Pepsi,Pull-Working,Sponsorships,Sports-athlete/team contracts,50,4903999,2451999,2452000,635349,317674,317675
LAB North,Guatemala,2025,CSD,Pepsi,Pull-Working,Sponsorships,Sports-on field or in show props,0,0,0,0,0,0,0
LAB North,Guatemala,2025,CSD,Pepsi,Pull-Working,Sponsorships,Sports-stadium contracts,0,0,0,0,0,0,0
LAB North,Guatemala,2025,Others,Sabores,Pull-Non-Working,Ad Production,Digital Ad Production,0,0,0,0,0,0,0
LAB North,Guatemala,2025,Others,Sabores,Pull-Non-Working,Ad Production,"TV, Print, Radio, OOH, Production",50,272416,136208,136208,35293,17646,17647
LAB North,Guatemala,2025,Others,Sabores,Pull-Non-Working,Agency Fees,Creative Agency Fees,0,0,0,0,0,0,0
LAB North,Guatemala,2025,Others,Sabores,Pull-Non-Working,Agency Fees,In Store & POS Design / Development,0,0,0,0,0,0,0
LAB North,Guatemala,2025,Others,Sabores,Pull-Non-Working,Agency Fees,Media Agency Fees,0,0,0,0,0,0,0
LAB North,Guatemala,2025,Others,Sabores,Pull-Non-Working,Agency Fees,Other,0,0,0,0,0,0,0
LAB North,Guatemala,2025,Others,Sabores,Pull-Non-Working,Agency Fees,Social Media / Influence Marketing,0,0,0,0,0,0,0
LAB North,Guatemala,2025,Others,Sabores,Pull-Non-Working,All Other Non-Working,Administrative fees,0,0,0,0,0,0,0
LAB North,Guatemala,2025,Others,Sabores,Pull-Non-Working,All Other Non-Working,Agency out of pocket,0,0,0,0,0,0,0
LAB North,Guatemala,2025,Others,Sabores,Pull-Non-Working,All Other Non-Working,CP out of pocket admin,0,0,0,0,0,0,0
LAB North,Guatemala,2025,Others,Sabores,Pull-Non-Working,All Other Non-Working,Grassroots/experiential out of pocket,0,0,0,0,0,0,0
LAB North,Guatemala,2025,Others,Sabores,Pull-Non-Working,All Other Non-Working,League/property- rights fee/options,0,0,0,0,0,0,0
LAB North,Guatemala,2025,Others,Sabores,Pull-Non-Working,All Other Non-Working,Market Research,0,0,0,0,0,0,0
LAB North,Guatemala,2025,Others,Sabores,Pull-Non-Working,All Other Non-Working,Non-allocated NW,0,0,0,0,0,0,0
LAB North,Guatemala,2025,Others,Sabores,Pull-Non-Working,All Other Non-Working,Other Non Working-non itemised talent,0,0,0,0,0,0,0
LAB North,Guatemala,2025,Others,Sabores,Pull-Non-Working,All Other Non-Working,PR out of pocket administrative,0,0,0,0,0,0,0
LAB North,Guatemala,2025,Others,Sabores,Pull-Non-Working,Innovation and Insight,Innovations,0,0,0,0,0,0,0
LAB North,Guatemala,2025,Others,Sabores,Pull-Non-Working,Innovation and Insight,Market Research,50,88030,44015,44015,11404,5702,5702
LAB North,Guatemala,2025,Others,Sabores,Pull-Non-Working,Package Design,Package design,0,0,0,0,0,0,0
LAB North,Guatemala,2025,Others,Sabores,Pull-Non-Working,Package Design,Package development,0,0,0,0,0,0,0
LAB North,Guatemala,2025,Others,Sabores,STB - Push,Capability Building/Other,Capability Building Other,0,0,0,0,0,0,0
LAB North,Guatemala,2025,Others,Sabores,STB - Push,Other Investments,CDA's,0,0,0,0,0,0,0
LAB North,Guatemala,2025,Others,Sabores,STB - Push,Other Investments,Capital (Coolers),0,0,0,0,0,0,0
LAB North,Guatemala,2025,Others,Sabores,STB - Push,Other Investments,Price Support,0,0,0,0,0,0,0
LAB North,Guatemala,2025,Others,Sabores,STB - Push,Other Investments,Vending / Racks,0,0,0,0,0,0,0
LAB North,Guatemala,2025,Others,Sabores,STB - Push,Other Trade,Frozen Funds,0,0,0,0,0,0,0
LAB North,Guatemala,2025,Others,Sabores,STB - Push,Other Trade,Other Trade,0,0,0,0,0,0,0
LAB North,Guatemala,2025,Others,Sabores,STB - Push,Trade Equipment,Coolers - New,0,0,0,0,0,0,0
LAB North,Guatemala,2025,Others,Sabores,STB - Push,Trade Equipment,Coolers - Refurbished,0,0,0,0,0,0,0
LAB North,Guatemala,2025,Others,Sabores,STB - Push,Trade Equipment,Post Mix / Pre Mix Equip.,0,0,0,0,0,0,0
LAB North,Guatemala,2025,Others,Sabores,STB - Push,Trade Equipment,Vending / Racks,0,0,0,0,0,0,0
LAB North,Guatemala,2025,Others,Sabores,STB - Push,Trade Programs,Distribution Incentives,0,0,0,0,0,0,0
LAB North,Guatemala,2025,Others,Sabores,STB - Push,Trade Programs,Innovation Investments,0,0,0,0,0,0,0
LAB North,Guatemala,2025,Others,Sabores,STB - Push,Trade Programs,Sales Incentives,0,0,0,0,0,0,0
LAB North,Guatemala,2025,Others,Sabores,STB - Push,Trade Programs,Space Investments,0,0,0,0,0,0,0
LAB North,Guatemala,2025,Others,Sabores,Pull-Working,All Other Working,Other Working - PR execution,0,0,0,0,0,0,0
LAB North,Guatemala,2025,Others,Sabores,Pull-Working,All Other Working,Other Working - activation,0,0,0,0,0,0,0
LAB North,Guatemala,2025,Others,Sabores,Pull-Working,All Other Working,Other Working - non allocated working,0,0,0,0,0,0,0
LAB North,Guatemala,2025,Others,Sabores,Pull-Working,Consumer Promotions,Consumer Promotions Execution,50,42836,21418,21418,5549,2774,2775
LAB North,Guatemala,2025,Others,Sabores,Pull-Working,Consumer Promotions,Coupons,0,0,0,0,0,0,0
LAB North,Guatemala,2025,Others,Sabores,Pull-Working,Consumer Promotions,Other,0,0,0,0,0,0,0
LAB North,Guatemala,2025,Others,Sabores,Pull-Working,Consumer Promotions,Premiums,0,0,0,0,0,0,0
LAB North,Guatemala,2025,Others,Sabores,Pull-Working,In Store & POS Execution,In-Store & POS Execution,50,41808,20904,20904,5416,2708,2708
LAB North,Guatemala,2025,Others,Sabores,Pull-Working,Media Placements,Cinema,0,0,0,0,0,0,0
LAB North,Guatemala,2025,Others,Sabores,Pull-Working,Media Placements,Digital,50,709551,354775,354776,91927,45963,45964
LAB North,Guatemala,2025,Others,Sabores,Pull-Working,Media Placements,OOH - Out Of Home,0,0,0,0,0,0,0
LAB North,Guatemala,2025,Others,Sabores,Pull-Working,Media Placements,Other,0,0,0,0,0,0,0
LAB North,Guatemala,2025,Others,Sabores,Pull-Working,Media Placements,Print,0,0,0,0,0,0,0
LAB North,Guatemala,2025,Others,Sabores,Pull-Working,Media Placements,Radio,0,0,0,0,0,0,0
LAB North,Guatemala,2025,Others,Sabores,Pull-Working,Media Placements,TV,0,0,0,0,0,0,0
LAB North,Guatemala,2025,Others,Sabores,Pull-Working,Sampling,Product Samples,0,0,0,0,0,0,0
LAB North,Guatemala,2025,Others,Sabores,Pull-Working,Sampling,Sampling Execution,0,0,0,0,0,0,0
LAB North,Guatemala,2025,Others,Sabores,Pull-Working,Sponsorships,Sponsorships-in game/ in show,0,0,0,0,0,0,0
LAB North,Guatemala,2025,Others,Sabores,Pull-Working,Sponsorships,Sports-athlete/team contracts,0,0,0,0,0,0,0
LAB North,Guatemala,2025,Others,Sabores,Pull-Working,Sponsorships,Sports-on field or in show props,0,0,0,0,0,0,0
LAB North,Guatemala,2025,Others,Sabores,Pull-Working,Sponsorships,Sports-stadium contracts,0,0,0,0,0,0,0
LAB North,HN-CBC,2025,Energy Drinks,AMP,Pull-Non-Working,Ad Production,Digital Ad Production,0,0,0,0,0,0,0
LAB North,HN-CBC,2025,Energy Drinks,AMP,Pull-Non-Working,Ad Production,"TV, Print, Radio, OOH, Production",50,596006,298003,298003,23053,11526,11527
LAB North,HN-CBC,2025,Energy Drinks,AMP,Pull-Non-Working,Agency Fees,Creative Agency Fees,0,0,0,0,0,0,0
LAB North,HN-CBC,2025,Energy Drinks,AMP,Pull-Non-Working,Agency Fees,In Store & POS Design / Development,0,0,0,0,0,0,0
LAB North,HN-CBC,2025,Energy Drinks,AMP,Pull-Non-Working,Agency Fees,Media Agency Fees,0,0,0,0,0,0,0
LAB North,HN-CBC,2025,Energy Drinks,AMP,Pull-Non-Working,Agency Fees,Other,0,0,0,0,0,0,0
LAB North,HN-CBC,2025,Energy Drinks,AMP,Pull-Non-Working,Agency Fees,Social Media / Influence Marketing,0,0,0,0,0,0,0
LAB North,HN-CBC,2025,Energy Drinks,AMP,Pull-Non-Working,All Other Non-Working,Administrative fees,0,0,0,0,0,0,0
LAB North,HN-CBC,2025,Energy Drinks,AMP,Pull-Non-Working,All Other Non-Working,Agency out of pocket,0,0,0,0,0,0,0
LAB North,HN-CBC,2025,Energy Drinks,AMP,Pull-Non-Working,All Other Non-Working,CP out of pocket admin,0,0,0,0,0,0,0
LAB North,HN-CBC,2025,Energy Drinks,AMP,Pull-Non-Working,All Other Non-Working,Grassroots/experiential out of pocket,0,0,0,0,0,0,0
LAB North,HN-CBC,2025,Energy Drinks,AMP,Pull-Non-Working,All Other Non-Working,League/property- rights fee/options,0,0,0,0,0,0,0
LAB North,HN-CBC,2025,Energy Drinks,AMP,Pull-Non-Working,All Other Non-Working,Market Research,0,0,0,0,0,0,0
LAB North,HN-CBC,2025,Energy Drinks,AMP,Pull-Non-Working,All Other Non-Working,Non-allocated NW,0,0,0,0,0,0,0
LAB North,HN-CBC,2025,Energy Drinks,AMP,Pull-Non-Working,All Other Non-Working,Other Non Working-non itemised talent,0,0,0,0,0,0,0
LAB North,HN-CBC,2025,Energy Drinks,AMP,Pull-Non-Working,All Other Non-Working,PR out of pocket administrative,0,0,0,0,0,0,0
LAB North,HN-CBC,2025,Energy Drinks,AMP,Pull-Non-Working,Innovation and Insight,Innovations,0,0,0,0,0,0,0
LAB North,HN-CBC,2025,Energy Drinks,AMP,Pull-Non-Working,Innovation and Insight,Market Research,0,0,0,0,0,0,0
LAB North,HN-CBC,2025,Energy Drinks,AMP,Pull-Non-Working,Package Design,Package design,0,0,0,0,0,0,0
LAB North,HN-CBC,2025,Energy Drinks,AMP,Pull-Non-Working,Package Design,Package development,0,0,0,0,0,0,0
LAB North,HN-CBC,2025,Energy Drinks,AMP,STB - Push,Capability Building/Other,Capability Building Other,0,0,0,0,0,0,0
LAB North,HN-CBC,2025,Energy Drinks,AMP,STB - Push,Other Investments,CDA's,0,0,0,0,0,0,0
LAB North,HN-CBC,2025,Energy Drinks,AMP,STB - Push,Other Investments,Capital (Coolers),0,0,0,0,0,0,0
LAB North,HN-CBC,2025,Energy Drinks,AMP,STB - Push,Other Investments,Price Support,50,17083447,8541723,8541724,660791,330395,330396
LAB North,HN-CBC,2025,Energy Drinks,AMP,STB - Push,Other Investments,Vending / Racks,0,0,0,0,0,0,0
LAB North,HN-CBC,2025,Energy Drinks,AMP,STB - Push,Other Trade,Frozen Funds,0,0,0,0,0,0,0
LAB North,HN-CBC,2025,Energy Drinks,AMP,STB - Push,Other Trade,Other Trade,0,0,0,0,0,0,0
LAB North,HN-CBC,2025,Energy Drinks,AMP,STB - Push,Trade Equipment,Coolers - New,0,0,0,0,0,0,0
LAB North,HN-CBC,2025,Energy Drinks,AMP,STB - Push,Trade Equipment,Coolers - Refurbished,0,0,0,0,0,0,0
LAB North,HN-CBC,2025,Energy Drinks,AMP,STB - Push,Trade Equipment,Post Mix / Pre Mix Equip.,0,0,0,0,0,0,0
LAB North,HN-CBC,2025,Energy Drinks,AMP,STB - Push,Trade Equipment,Vending / Racks,0,0,0,0,0,0,0
LAB North,HN-CBC,2025,Energy Drinks,AMP,STB - Push,Trade Programs,Distribution Incentives,0,0,0,0,0,0,0
LAB North,HN-CBC,2025,Energy Drinks,AMP,STB - Push,Trade Programs,Innovation Investments,0,0,0,0,0,0,0
LAB North,HN-CBC,2025,Energy Drinks,AMP,STB - Push,Trade Programs,Sales Incentives,0,0,0,0,0,0,0
LAB North,HN-CBC,2025,Energy Drinks,AMP,STB - Push,Trade Programs,Space Investments,0,0,0,0,0,0,0
LAB North,HN-CBC,2025,Energy Drinks,AMP,Pull-Working,All Other Working,Other Working - PR execution,50,259301,129650,129651,10029,5014,5015
LAB North,HN-CBC,2025,Energy Drinks,AMP,Pull-Working,All Other Working,Other Working - activation,0,0,0,0,0,0,0
LAB North,HN-CBC,2025,Energy Drinks,AMP,Pull-Working,All Other Working,Other Working - non allocated working,0,0,0,0,0,0,0
LAB North,HN-CBC,2025,Energy Drinks,AMP,Pull-Working,Consumer Promotions,Consumer Promotions Execution,50,1450383,725191,725192,56101,28050,28051
LAB North,HN-CBC,2025,Energy Drinks,AMP,Pull-Working,Consumer Promotions,Coupons,0,0,0,0,0,0,0
LAB North,HN-CBC,2025,Energy Drinks,AMP,Pull-Working,Consumer Promotions,Other,0,0,0,0,0,0,0
LAB North,HN-CBC,2025,Energy Drinks,AMP,Pull-Working,Consumer Promotions,Premiums,0,0,0,0,0,0,0
LAB North,HN-CBC,2025,Energy Drinks,AMP,Pull-Working,In Store & POS Execution,In-Store & POS Execution,0,0,0,0,0,0,0
LAB North,HN-CBC,2025,Energy Drinks,AMP,Pull-Working,Media Placements,Cinema,0,0,0,0,0,0,0
LAB North,HN-CBC,2025,Energy Drinks,AMP,Pull-Working,Media Placements,Digital,50,4120922,2060461,2060461,159398,79699,79699
LAB North,HN-CBC,2025,Energy Drinks,AMP,Pull-Working,Media Placements,OOH - Out Of Home,50,2401535,1200767,1200768,92891,46445,46446
LAB North,HN-CBC,2025,Energy Drinks,AMP,Pull-Working,Media Placements,Other,50,570000,285000,285000,22047,11023,11024
LAB North,HN-CBC,2025,Energy Drinks,AMP,Pull-Working,Media Placements,Print,0,0,0,0,0,0,0
LAB North,HN-CBC,2025,Energy Drinks,AMP,Pull-Working,Media Placements,Radio,50,465299,232649,232650,17997,8998,8999
LAB North,HN-CBC,2025,Energy Drinks,AMP,Pull-Working,Media Placements,TV,50,1861196,930598,930598,71991,35995,35996
LAB North,HN-CBC,2025,Energy Drinks,AMP,Pull-Working,Sampling,Product Samples,0,0,0,0,0,0,0
LAB North,HN-CBC,2025,Energy Drinks,AMP,Pull-Working,Sampling,Sampling Execution,50,880383,440191,440192,34053,17026,17027
LAB North,HN-CBC,2025,Energy Drinks,AMP,Pull-Working,Sponsorships,Sponsorships-in game/ in show,0,0,0,0,0,0,0
LAB North,HN-CBC,2025,Energy Drinks,AMP,Pull-Working,Sponsorships,Sports-athlete/team contracts,0,0,0,0,0,0,0
LAB North,HN-CBC,2025,Energy Drinks,AMP,Pull-Working,Sponsorships,Sports-on field or in show props,0,0,0,0,0,0,0
LAB North,HN-CBC,2025,Energy Drinks,AMP,Pull-Working,Sponsorships,Sports-stadium contracts,0,0,0,0,0,0,0
LAB North,HN-CBC,2025,Energy Drinks,Adrenaline,Pull-Non-Working,Ad Production,Digital Ad Production,0,0,0,0,0,0,0
LAB North,HN-CBC,2025,Energy Drinks,Adrenaline,Pull-Non-Working,Ad Production,"TV, Print, Radio, OOH, Production",50,1575974,787987,787987,60959,30479,30480
LAB North,HN-CBC,2025,Energy Drinks,Adrenaline,Pull-Non-Working,Agency Fees,Creative Agency Fees,0,0,0,0,0,0,0
LAB North,HN-CBC,2025,Energy Drinks,Adrenaline,Pull-Non-Working,Agency Fees,In Store & POS Design / Development,0,0,0,0,0,0,0
LAB North,HN-CBC,2025,Energy Drinks,Adrenaline,Pull-Non-Working,Agency Fees,Media Agency Fees,0,0,0,0,0,0,0
LAB North,HN-CBC,2025,Energy Drinks,Adrenaline,Pull-Non-Working,Agency Fees,Other,0,0,0,0,0,0,0
LAB North,HN-CBC,2025,Energy Drinks,Adrenaline,Pull-Non-Working,Agency Fees,Social Media / Influence Marketing,0,0,0,0,0,0,0
LAB North,HN-CBC,2025,Energy Drinks,Adrenaline,Pull-Non-Working,All Other Non-Working,Administrative fees,0,0,0,0,0,0,0
LAB North,HN-CBC,2025,Energy Drinks,Adrenaline,Pull-Non-Working,All Other Non-Working,Agency out of pocket,0,0,0,0,0,0,0
LAB North,HN-CBC,2025,Energy Drinks,Adrenaline,Pull-Non-Working,All Other Non-Working,CP out of pocket admin,0,0,0,0,0,0,0
LAB North,HN-CBC,2025,Energy Drinks,Adrenaline,Pull-Non-Working,All Other Non-Working,Grassroots/experiential out of pocket,0,0,0,0,0,0,0
LAB North,HN-CBC,2025,Energy Drinks,Adrenaline,Pull-Non-Working,All Other Non-Working,League/property- rights fee/options,0,0,0,0,0,0,0
LAB North,HN-CBC,2025,Energy Drinks,Adrenaline,Pull-Non-Working,All Other Non-Working,Market Research,0,0,0,0,0,0,0
LAB North,HN-CBC,2025,Energy Drinks,Adrenaline,Pull-Non-Working,All Other Non-Working,Non-allocated NW,0,0,0,0,0,0,0
LAB North,HN-CBC,2025,Energy Drinks,Adrenaline,Pull-Non-Working,All Other Non-Working,Other Non Working-non itemised talent,0,0,0,0,0,0,0
LAB North,HN-CBC,2025,Energy Drinks,Adrenaline,Pull-Non-Working,All Other Non-Working,PR out of pocket administrative,0,0,0,0,0,0,0
LAB North,HN-CBC,2025,Energy Drinks,Adrenaline,Pull-Non-Working,Innovation and Insight,Innovations,0,0,0,0,0,0,0
LAB North,HN-CBC,2025,Energy Drinks,Adrenaline,Pull-Non-Working,Innovation and Insight,Market Research,0,0,0,0,0,0,0
LAB North,HN-CBC,2025,Energy Drinks,Adrenaline,Pull-Non-Working,Package Design,Package design,0,0,0,0,0,0,0
LAB North,HN-CBC,2025,Energy Drinks,Adrenaline,Pull-Non-Working,Package Design,Package development,0,0,0,0,0,0,0
LAB North,HN-CBC,2025,Energy Drinks,Adrenaline,STB - Push,Capability Building/Other,Capability Building Other,0,0,0,0,0,0,0
LAB North,HN-CBC,2025,Energy Drinks,Adrenaline,STB - Push,Other Investments,CDA's,0,0,0,0,0,0,0
LAB North,HN-CBC,2025,Energy Drinks,Adrenaline,STB - Push,Other Investments,Capital (Coolers),0,0,0,0,0,0,0
LAB North,HN-CBC,2025,Energy Drinks,Adrenaline,STB - Push,Other Investments,Price Support,50,10680103,5340051,5340052,413108,206554,206554
LAB North,HN-CBC,2025,Energy Drinks,Adrenaline,STB - Push,Other Investments,Vending / Racks,0,0,0,0,0,0,0
LAB North,HN-CBC,2025,Energy Drinks,Adrenaline,STB - Push,Other Trade,Frozen Funds,0,0,0,0,0,0,0
LAB North,HN-CBC,2025,Energy Drinks,Adrenaline,STB - Push,Other Trade,Other Trade,0,0,0,0,0,0,0
LAB North,HN-CBC,2025,Energy Drinks,Adrenaline,STB - Push,Trade Equipment,Coolers - New,0,0,0,0,0,0,0
LAB North,HN-CBC,2025,Energy Drinks,Adrenaline,STB - Push,Trade Equipment,Coolers - Refurbished,0,0,0,0,0,0,0
LAB North,HN-CBC,2025,Energy Drinks,Adrenaline,STB - Push,Trade Equipment,Post Mix / Pre Mix Equip.,0,0,0,0,0,0,0
LAB North,HN-CBC,2025,Energy Drinks,Adrenaline,STB - Push,Trade Equipment,Vending / Racks,0,0,0,0,0,0,0
LAB North,HN-CBC,2025,Energy Drinks,Adrenaline,STB - Push,Trade Programs,Distribution Incentives,0,0,0,0,0,0,0
LAB North,HN-CBC,2025,Energy Drinks,Adrenaline,STB - Push,Trade Programs,Innovation Investments,0,0,0,0,0,0,0
LAB North,HN-CBC,2025,Energy Drinks,Adrenaline,STB - Push,Trade Programs,Sales Incentives,0,0,0,0,0,0,0
LAB North,HN-CBC,2025,Energy Drinks,Adrenaline,STB - Push,Trade Programs,Space Investments,0,0,0,0,0,0,0
LAB North,HN-CBC,2025,Energy Drinks,Adrenaline,Pull-Working,All Other Working,Other Working - PR execution,0,0,0,0,0,0,0
LAB North,HN-CBC,2025,Energy Drinks,Adrenaline,Pull-Working,All Other Working,Other Working - activation,0,0,0,0,0,0,0
LAB North,HN-CBC,2025,Energy Drinks,Adrenaline,Pull-Working,All Other Working,Other Working - non allocated working,0,0,0,0,0,0,0
LAB North,HN-CBC,2025,Energy Drinks,Adrenaline,Pull-Working,Consumer Promotions,Consumer Promotions Execution,0,0,0,0,0,0,0
LAB North,HN-CBC,2025,Energy Drinks,Adrenaline,Pull-Working,Consumer Promotions,Coupons,0,0,0,0,0,0,0
LAB North,HN-CBC,2025,Energy Drinks,Adrenaline,Pull-Working,Consumer Promotions,Other,0,0,0,0,0,0,0
LAB North,HN-CBC,2025,Energy Drinks,Adrenaline,Pull-Working,Consumer Promotions,Premiums,50,383599,191799,191800,14837,7418,7419
LAB North,HN-CBC,2025,Energy Drinks,Adrenaline,Pull-Working,In Store & POS Execution,In-Store & POS Execution,0,0,0,0,0,0,0
LAB North,HN-CBC,2025,Energy Drinks,Adrenaline,Pull-Working,Media Placements,Cinema,0,0,0,0,0,0,0
LAB North,HN-CBC,2025,Energy Drinks,Adrenaline,Pull-Working,Media Placements,Digital,50,1110768,555384,555384,42964,21482,21482
LAB North,HN-CBC,2025,Energy Drinks,Adrenaline,Pull-Working,Media Placements,OOH - Out Of Home,0,0,0,0,0,0,0
LAB North,HN-CBC,2025,Energy Drinks,Adrenaline,Pull-Working,Media Placements,Other,0,0,0,0,0,0,0
LAB North,HN-CBC,2025,Energy Drinks,Adrenaline,Pull-Working,Media Placements,Print,0,0,0,0,0,0,0
LAB North,HN-CBC,2025,Energy Drinks,Adrenaline,Pull-Working,Media Placements,Radio,0,0,0,0,0,0,0
LAB North,HN-CBC,2025,Energy Drinks,Adrenaline,Pull-Working,Media Placements,TV,0,0,0,0,0,0,0
LAB North,HN-CBC,2025,Energy Drinks,Adrenaline,Pull-Working,Sampling,Product Samples,50,24323,12161,12162,940,470,470
LAB North,HN-CBC,2025,Energy Drinks,Adrenaline,Pull-Working,Sampling,Sampling Execution,0,0,0,0,0,0,0
LAB North,HN-CBC,2025,Energy Drinks,Adrenaline,Pull-Working,Sponsorships,Sponsorships-in game/ in show,50,18668,9334,9334,722,361,361
LAB North,HN-CBC,2025,Energy Drinks,Adrenaline,Pull-Working,Sponsorships,Sports-athlete/team contracts,0,0,0,0,0,0,0
LAB North,HN-CBC,2025,Energy Drinks,Adrenaline,Pull-Working,Sponsorships,Sports-on field or in show props,0,0,0,0,0,0,0
LAB North,HN-CBC,2025,Energy Drinks,Adrenaline,Pull-Working,Sponsorships,Sports-stadium contracts,0,0,0,0,0,0,0
LAB North,HN-CBC,2025,Sport Drinks,Gatorade,Pull-Non-Working,Ad Production,Digital Ad Production,0,0,0,0,0,0,0
LAB North,HN-CBC,2025,Sport Drinks,Gatorade,Pull-Non-Working,Ad Production,"TV, Print, Radio, OOH, Production",50,1992859,996429,996430,77084,38542,38542
LAB North,HN-CBC,2025,Sport Drinks,Gatorade,Pull-Non-Working,Agency Fees,Creative Agency Fees,0,0,0,0,0,0,0
LAB North,HN-CBC,2025,Sport Drinks,Gatorade,Pull-Non-Working,Agency Fees,In Store & POS Design / Development,0,0,0,0,0,0,0
LAB North,HN-CBC,2025,Sport Drinks,Gatorade,Pull-Non-Working,Agency Fees,Media Agency Fees,0,0,0,0,0,0,0
LAB North,HN-CBC,2025,Sport Drinks,Gatorade,Pull-Non-Working,Agency Fees,Other,0,0,0,0,0,0,0
LAB North,HN-CBC,2025,Sport Drinks,Gatorade,Pull-Non-Working,Agency Fees,Social Media / Influence Marketing,0,0,0,0,0,0,0
LAB North,HN-CBC,2025,Sport Drinks,Gatorade,Pull-Non-Working,All Other Non-Working,Administrative fees,0,0,0,0,0,0,0
LAB North,HN-CBC,2025,Sport Drinks,Gatorade,Pull-Non-Working,All Other Non-Working,Agency out of pocket,0,0,0,0,0,0,0
LAB North,HN-CBC,2025,Sport Drinks,Gatorade,Pull-Non-Working,All Other Non-Working,CP out of pocket admin,0,0,0,0,0,0,0
LAB North,HN-CBC,2025,Sport Drinks,Gatorade,Pull-Non-Working,All Other Non-Working,Grassroots/experiential out of pocket,0,0,0,0,0,0,0
LAB North,HN-CBC,2025,Sport Drinks,Gatorade,Pull-Non-Working,All Other Non-Working,League/property- rights fee/options,0,0,0,0,0,0,0
LAB North,HN-CBC,2025,Sport Drinks,Gatorade,Pull-Non-Working,All Other Non-Working,Market Research,0,0,0,0,0,0,0
LAB North,HN-CBC,2025,Sport Drinks,Gatorade,Pull-Non-Working,All Other Non-Working,Non-allocated NW,0,0,0,0,0,0,0
LAB North,HN-CBC,2025,Sport Drinks,Gatorade,Pull-Non-Working,All Other Non-Working,Other Non Working-non itemised talent,0,0,0,0,0,0,0
LAB North,HN-CBC,2025,Sport Drinks,Gatorade,Pull-Non-Working,All Other Non-Working,PR out of pocket administrative,0,0,0,0,0,0,0
LAB North,HN-CBC,2025,Sport Drinks,Gatorade,Pull-Non-Working,Innovation and Insight,Innovations,0,0,0,0,0,0,0
LAB North,HN-CBC,2025,Sport Drinks,Gatorade,Pull-Non-Working,Innovation and Insight,Market Research,0,0,0,0,0,0,0
LAB North,HN-CBC,2025,Sport Drinks,Gatorade,Pull-Non-Working,Package Design,Package design,0,0,0,0,0,0,0
LAB North,HN-CBC,2025,Sport Drinks,Gatorade,Pull-Non-Working,Package Design,Package development,0,0,0,0,0,0,0
LAB North,HN-CBC,2025,Sport Drinks,Gatorade,STB - Push,Capability Building/Other,Capability Building Other,0,0,0,0,0,0,0
LAB North,HN-CBC,2025,Sport Drinks,Gatorade,STB - Push,Other Investments,CDA's,0,0,0,0,0,0,0
LAB North,HN-CBC,2025,Sport Drinks,Gatorade,STB - Push,Other Investments,Capital (Coolers),0,0,0,0,0,0,0
LAB North,HN-CBC,2025,Sport Drinks,Gatorade,STB - Push,Other Investments,Price Support,50,19633763,9816881,9816882,759438,379719,379719
LAB North,HN-CBC,2025,Sport Drinks,Gatorade,STB - Push,Other Investments,Vending / Racks,0,0,0,0,0,0,0
LAB North,HN-CBC,2025,Sport Drinks,Gatorade,STB - Push,Other Trade,Frozen Funds,0,0,0,0,0,0,0
LAB North,HN-CBC,2025,Sport Drinks,Gatorade,STB - Push,Other Trade,Other Trade,0,0,0,0,0,0,0
LAB North,HN-CBC,2025,Sport Drinks,Gatorade,STB - Push,Trade Equipment,Coolers - New,0,0,0,0,0,0,0
LAB North,HN-CBC,2025,Sport Drinks,Gatorade,STB - Push,Trade Equipment,Coolers - Refurbished,0,0,0,0,0,0,0
LAB North,HN-CBC,2025,Sport Drinks,Gatorade,STB - Push,Trade Equipment,Post Mix / Pre Mix Equip.,0,0,0,0,0,0,0
LAB North,HN-CBC,2025,Sport Drinks,Gatorade,STB - Push,Trade Equipment,Vending / Racks,0,0,0,0,0,0,0
LAB North,HN-CBC,2025,Sport Drinks,Gatorade,STB - Push,Trade Programs,Distribution Incentives,0,0,0,0,0,0,0
LAB North,HN-CBC,2025,Sport Drinks,Gatorade,STB - Push,Trade Programs,Innovation Investments,0,0,0,0,0,0,0
LAB North,HN-CBC,2025,Sport Drinks,Gatorade,STB - Push,Trade Programs,Sales Incentives,0,0,0,0,0,0,0
LAB North,HN-CBC,2025,Sport Drinks,Gatorade,STB - Push,Trade Programs,Space Investments,0,0,0,0,0,0,0
LAB North,HN-CBC,2025,Sport Drinks,Gatorade,Pull-Working,All Other Working,Other Working - PR execution,0,0,0,0,0,0,0
LAB North,HN-CBC,2025,Sport Drinks,Gatorade,Pull-Working,All Other Working,Other Working - activation,0,0,0,0,0,0,0
LAB North,HN-CBC,2025,Sport Drinks,Gatorade,Pull-Working,All Other Working,Other Working - non allocated working,0,0,0,0,0,0,0
LAB North,HN-CBC,2025,Sport Drinks,Gatorade,Pull-Working,Consumer Promotions,Consumer Promotions Execution,50,95208,47604,47604,3682,1841,1841
LAB North,HN-CBC,2025,Sport Drinks,Gatorade,Pull-Working,Consumer Promotions,Coupons,0,0,0,0,0,0,0
LAB North,HN-CBC,2025,Sport Drinks,Gatorade,Pull-Working,Consumer Promotions,Other,0,0,0,0,0,0,0
LAB North,HN-CBC,2025,Sport Drinks,Gatorade,Pull-Working,Consumer Promotions,Premiums,50,1609593,804796,804797,62259,31129,31130
LAB North,HN-CBC,2025,Sport Drinks,Gatorade,Pull-Working,In Store & POS Execution,In-Store & POS Execution,0,0,0,0,0,0,0
LAB North,HN-CBC,2025,Sport Drinks,Gatorade,Pull-Working,Media Placements,Cinema,0,0,0,0,0,0,0
LAB North,HN-CBC,2025,Sport Drinks,Gatorade,Pull-Working,Media Placements,Digital,50,2990911,1495455,1495456,115689,57844,57845
LAB North,HN-CBC,2025,Sport Drinks,Gatorade,Pull-Working,Media Placements,OOH - Out Of Home,50,2008817,1004408,1004409,77701,38850,38851
LAB North,HN-CBC,2025,Sport Drinks,Gatorade,Pull-Working,Media Placements,Other,0,0,0,0,0,0,0
LAB North,HN-CBC,2025,Sport Drinks,Gatorade,Pull-Working,Media Placements,Print,0,0,0,0,0,0,0
LAB North,HN-CBC,2025,Sport Drinks,Gatorade,Pull-Working,Media Placements,Radio,50,132579,66289,66290,5128,2564,2564
LAB North,HN-CBC,2025,Sport Drinks,Gatorade,Pull-Working,Media Placements,TV,50,530317,265158,265159,20512,10256,10256
LAB North,HN-CBC,2025,Sport Drinks,Gatorade,Pull-Working,Sampling,Product Samples,50,53946,26973,26973,2086,1043,1043
LAB North,HN-CBC,2025,Sport Drinks,Gatorade,Pull-Working,Sampling,Sampling Execution,50,95208,47604,47604,3682,1841,1841
LAB North,HN-CBC,2025,Sport Drinks,Gatorade,Pull-Working,Sponsorships,Sponsorships-in game/ in show,50,253975,126987,126988,9823,4911,4912
LAB North,HN-CBC,2025,Sport Drinks,Gatorade,Pull-Working,Sponsorships,Sports-athlete/team contracts,0,0,0,0,0,0,0
LAB North,HN-CBC,2025,Sport Drinks,Gatorade,Pull-Working,Sponsorships,Sports-on field or in show props,0,0,0,0,0,0,0
LAB North,HN-CBC,2025,Sport Drinks,Gatorade,Pull-Working,Sponsorships,Sports-stadium contracts,0,0,0,0,0,0,0
LAB North,HN-CBC,2025,RTD Tea,Lipton,Pull-Non-Working,Ad Production,Digital Ad Production,0,0,0,0,0,0,0
LAB North,HN-CBC,2025,RTD Tea,Lipton,Pull-Non-Working,Ad Production,"TV, Print, Radio, OOH, Production",50,1290859,645429,645430,49930,24965,24965
LAB North,HN-CBC,2025,RTD Tea,Lipton,Pull-Non-Working,Agency Fees,Creative Agency Fees,0,0,0,0,0,0,0
LAB North,HN-CBC,2025,RTD Tea,Lipton,Pull-Non-Working,Agency Fees,In Store & POS Design / Development,0,0,0,0,0,0,0
LAB North,HN-CBC,2025,RTD Tea,Lipton,Pull-Non-Working,Agency Fees,Media Agency Fees,0,0,0,0,0,0,0
LAB North,HN-CBC,2025,RTD Tea,Lipton,Pull-Non-Working,Agency Fees,Other,0,0,0,0,0,0,0
LAB North,HN-CBC,2025,RTD Tea,Lipton,Pull-Non-Working,Agency Fees,Social Media / Influence Marketing,0,0,0,0,0,0,0
LAB North,HN-CBC,2025,RTD Tea,Lipton,Pull-Non-Working,All Other Non-Working,Administrative fees,0,0,0,0,0,0,0
LAB North,HN-CBC,2025,RTD Tea,Lipton,Pull-Non-Working,All Other Non-Working,Agency out of pocket,0,0,0,0,0,0,0
LAB North,HN-CBC,2025,RTD Tea,Lipton,Pull-Non-Working,All Other Non-Working,CP out of pocket admin,0,0,0,0,0,0,0
LAB North,HN-CBC,2025,RTD Tea,Lipton,Pull-Non-Working,All Other Non-Working,Grassroots/experiential out of pocket,0,0,0,0,0,0,0
LAB North,HN-CBC,2025,RTD Tea,Lipton,Pull-Non-Working,All Other Non-Working,League/property- rights fee/options,0,0,0,0,0,0,0
LAB North,HN-CBC,2025,RTD Tea,Lipton,Pull-Non-Working,All Other Non-Working,Market Research,0,0,0,0,0,0,0
LAB North,HN-CBC,2025,RTD Tea,Lipton,Pull-Non-Working,All Other Non-Working,Non-allocated NW,0,0,0,0,0,0,0
LAB North,HN-CBC,2025,RTD Tea,Lipton,Pull-Non-Working,All Other Non-Working,Other Non Working-non itemised talent,0,0,0,0,0,0,0
LAB North,HN-CBC,2025,RTD Tea,Lipton,Pull-Non-Working,All Other Non-Working,PR out of pocket administrative,0,0,0,0,0,0,0
LAB North,HN-CBC,2025,RTD Tea,Lipton,Pull-Non-Working,Innovation and Insight,Innovations,0,0,0,0,0,0,0
LAB North,HN-CBC,2025,RTD Tea,Lipton,Pull-Non-Working,Innovation and Insight,Market Research,0,0,0,0,0,0,0
LAB North,HN-CBC,2025,RTD Tea,Lipton,Pull-Non-Working,Package Design,Package design,0,0,0,0,0,0,0
LAB North,HN-CBC,2025,RTD Tea,Lipton,Pull-Non-Working,Package Design,Package development,0,0,0,0,0,0,0
LAB North,HN-CBC,2025,RTD Tea,Lipton,STB - Push,Capability Building/Other,Capability Building Other,0,0,0,0,0,0,0
LAB North,HN-CBC,2025,RTD Tea,Lipton,STB - Push,Other Investments,CDA's,0,0,0,0,0,0,0
LAB North,HN-CBC,2025,RTD Tea,Lipton,STB - Push,Other Investments,Capital (Coolers),0,0,0,0,0,0,0
LAB North,HN-CBC,2025,RTD Tea,Lipton,STB - Push,Other Investments,Price Support,50,19485118,9742559,9742559,753688,376844,376844
LAB North,HN-CBC,2025,RTD Tea,Lipton,STB - Push,Other Investments,Vending / Racks,0,0,0,0,0,0,0
LAB North,HN-CBC,2025,RTD Tea,Lipton,STB - Push,Other Trade,Frozen Funds,0,0,0,0,0,0,0
LAB North,HN-CBC,2025,RTD Tea,Lipton,STB - Push,Other Trade,Other Trade,0,0,0,0,0,0,0
LAB North,HN-CBC,2025,RTD Tea,Lipton,STB - Push,Trade Equipment,Coolers - New,0,0,0,0,0,0,0
LAB North,HN-CBC,2025,RTD Tea,Lipton,STB - Push,Trade Equipment,Coolers - Refurbished,0,0,0,0,0,0,0
LAB North,HN-CBC,2025,RTD Tea,Lipton,STB - Push,Trade Equipment,Post Mix / Pre Mix Equip.,0,0,0,0,0,0,0
LAB North,HN-CBC,2025,RTD Tea,Lipton,STB - Push,Trade Equipment,Vending / Racks,0,0,0,0,0,0,0
LAB North,HN-CBC,2025,RTD Tea,Lipton,STB - Push,Trade Programs,Distribution Incentives,0,0,0,0,0,0,0
LAB North,HN-CBC,2025,RTD Tea,Lipton,STB - Push,Trade Programs,Innovation Investments,0,0,0,0,0,0,0
LAB North,HN-CBC,2025,RTD Tea,Lipton,STB - Push,Trade Programs,Sales Incentives,0,0,0,0,0,0,0
LAB North,HN-CBC,2025,RTD Tea,Lipton,STB - Push,Trade Programs,Space Investments,0,0,0,0,0,0,0
LAB North,HN-CBC,2025,RTD Tea,Lipton,Pull-Working,All Other Working,Other Working - PR execution,50,115389,57694,57695,4463,2231,2232
LAB North,HN-CBC,2025,RTD Tea,Lipton,Pull-Working,All Other Working,Other Working - activation,0,0,0,0,0,0,0
LAB North,HN-CBC,2025,RTD Tea,Lipton,Pull-Working,All Other Working,Other Working - non allocated working,0,0,0,0,0,0,0
LAB North,HN-CBC,2025,RTD Tea,Lipton,Pull-Working,Consumer Promotions,Consumer Promotions Execution,0,0,0,0,0,0,0
LAB North,HN-CBC,2025,RTD Tea,Lipton,Pull-Working,Consumer Promotions,Coupons,0,0,0,0,0,0,0
LAB North,HN-CBC,2025,RTD Tea,Lipton,Pull-Working,Consumer Promotions,Other,0,0,0,0,0,0,0
LAB North,HN-CBC,2025,RTD Tea,Lipton,Pull-Working,Consumer Promotions,Premiums,50,558233,279116,279117,21592,10796,10796
LAB North,HN-CBC,2025,RTD Tea,Lipton,Pull-Working,In Store & POS Execution,In-Store & POS Execution,0,0,0,0,0,0,0
LAB North,HN-CBC,2025,RTD Tea,Lipton,Pull-Working,Media Placements,Cinema,0,0,0,0,0,0,0
LAB North,HN-CBC,2025,RTD Tea,Lipton,Pull-Working,Media Placements,Digital,50,1869567,934783,934784,72315,36157,36158
LAB North,HN-CBC,2025,RTD Tea,Lipton,Pull-Working,Media Placements,OOH - Out Of Home,0,0,0,0,0,0,0
LAB North,HN-CBC,2025,RTD Tea,Lipton,Pull-Working,Media Placements,Other,0,0,0,0,0,0,0
LAB North,HN-CBC,2025,RTD Tea,Lipton,Pull-Working,Media Placements,Print,0,0,0,0,0,0,0
LAB North,HN-CBC,2025,RTD Tea,Lipton,Pull-Working,Media Placements,Radio,0,0,0,0,0,0,0
LAB North,HN-CBC,2025,RTD Tea,Lipton,Pull-Working,Media Placements,TV,0,0,0,0,0,0,0
LAB North,HN-CBC,2025,RTD Tea,Lipton,Pull-Working,Sampling,Product Samples,50,22785,11392,11393,881,440,441
LAB North,HN-CBC,2025,RTD Tea,Lipton,Pull-Working,Sampling,Sampling Execution,0,0,0,0,0,0,0
LAB North,HN-CBC,2025,RTD Tea,Lipton,Pull-Working,Sponsorships,Sponsorships-in game/ in show,50,82824,41412,41412,3203,1601,1602
LAB North,HN-CBC,2025,RTD Tea,Lipton,Pull-Working,Sponsorships,Sports-athlete/team contracts,0,0,0,0,0,0,0
LAB North,HN-CBC,2025,RTD Tea,Lipton,Pull-Working,Sponsorships,Sports-on field or in show props,0,0,0,0,0,0,0
LAB North,HN-CBC,2025,RTD Tea,Lipton,Pull-Working,Sponsorships,Sports-stadium contracts,0,0,0,0,0,0,0
LAB North,HN-CBC,2025,CSD,Pepsi,Pull-Non-Working,Ad Production,Digital Ad Production,0,0,0,0,0,0,0
LAB North,HN-CBC,2025,CSD,Pepsi,Pull-Non-Working,Ad Production,"TV, Print, Radio, OOH, Production",50,8308529,4154264,4154265,321375,160687,160688
LAB North,HN-CBC,2025,CSD,Pepsi,Pull-Non-Working,Agency Fees,Creative Agency Fees,0,0,0,0,0,0,0
LAB North,HN-CBC,2025,CSD,Pepsi,Pull-Non-Working,Agency Fees,In Store & POS Design / Development,0,0,0,0,0,0,0
LAB North,HN-CBC,2025,CSD,Pepsi,Pull-Non-Working,Agency Fees,Media Agency Fees,0,0,0,0,0,0,0
LAB North,HN-CBC,2025,CSD,Pepsi,Pull-Non-Working,Agency Fees,Other,0,0,0,0,0,0,0
LAB North,HN-CBC,2025,CSD,Pepsi,Pull-Non-Working,Agency Fees,Social Media / Influence Marketing,0,0,0,0,0,0,0
LAB North,HN-CBC,2025,CSD,Pepsi,Pull-Non-Working,All Other Non-Working,Administrative fees,0,0,0,0,0,0,0
LAB North,HN-CBC,2025,CSD,Pepsi,Pull-Non-Working,All Other Non-Working,Agency out of pocket,0,0,0,0,0,0,0
LAB North,HN-CBC,2025,CSD,Pepsi,Pull-Non-Working,All Other Non-Working,CP out of pocket admin,0,0,0,0,0,0,0
LAB North,HN-CBC,2025,CSD,Pepsi,Pull-Non-Working,All Other Non-Working,Grassroots/experiential out of pocket,0,0,0,0,0,0,0
LAB North,HN-CBC,2025,CSD,Pepsi,Pull-Non-Working,All Other Non-Working,League/property- rights fee/options,0,0,0,0,0,0,0
LAB North,HN-CBC,2025,CSD,Pepsi,Pull-Non-Working,All Other Non-Working,Market Research,0,0,0,0,0,0,0
LAB North,HN-CBC,2025,CSD,Pepsi,Pull-Non-Working,All Other Non-Working,Non-allocated NW,0,0,0,0,0,0,0
LAB North,HN-CBC,2025,CSD,Pepsi,Pull-Non-Working,All Other Non-Working,Other Non Working-non itemised talent,0,0,0,0,0,0,0
LAB North,HN-CBC,2025,CSD,Pepsi,Pull-Non-Working,All Other Non-Working,PR out of pocket administrative,0,0,0,0,0,0,0
LAB North,HN-CBC,2025,CSD,Pepsi,Pull-Non-Working,Innovation and Insight,Innovations,0,0,0,0,0,0,0
LAB North,HN-CBC,2025,CSD,Pepsi,Pull-Non-Working,Innovation and Insight,Market Research,50,9796983,4898491,4898492,378949,189474,189475
LAB North,HN-CBC,2025,CSD,Pepsi,Pull-Non-Working,Package Design,Package design,0,0,0,0,0,0,0
LAB North,HN-CBC,2025,CSD,Pepsi,Pull-Non-Working,Package Design,Package development,0,0,0,0,0,0,0
LAB North,HN-CBC,2025,CSD,Pepsi,STB - Push,Capability Building/Other,Capability Building Other,0,0,0,0,0,0,0
LAB North,HN-CBC,2025,CSD,Pepsi,STB - Push,Other Investments,CDA's,50,8573864,4286932,4286932,331638,165819,165819
LAB North,HN-CBC,2025,CSD,Pepsi,STB - Push,Other Investments,Capital (Coolers),0,0,0,0,0,0,0
LAB North,HN-CBC,2025,CSD,Pepsi,STB - Push,Other Investments,Price Support,50,182996710,91498355,91498355,7078351,3539175,3539176
LAB North,HN-CBC,2025,CSD,Pepsi,STB - Push,Other Investments,Vending / Racks,0,0,0,0,0,0,0
LAB North,HN-CBC,2025,CSD,Pepsi,STB - Push,Other Trade,Frozen Funds,0,0,0,0,0,0,0
LAB North,HN-CBC,2025,CSD,Pepsi,STB - Push,Other Trade,Other Trade,50,15223358,7611679,7611679,588842,294421,294421
LAB North,HN-CBC,2025,CSD,Pepsi,STB - Push,Trade Equipment,Coolers - New,50,34295830,17147915,17147915,1326569,663284,663285
LAB North,HN-CBC,2025,CSD,Pepsi,STB - Push,Trade Equipment,Coolers - Refurbished,0,0,0,0,0,0,0
LAB North,HN-CBC,2025,CSD,Pepsi,STB - Push,Trade Equipment,Post Mix / Pre Mix Equip.,50,6049535,3024767,3024768,233997,116998,116999
LAB North,HN-CBC,2025,CSD,Pepsi,STB - Push,Trade Equipment,Vending / Racks,50,5674156,2837078,2837078,219477,109738,109739
LAB North,HN-CBC,2025,CSD,Pepsi,STB - Push,Trade Programs,Distribution Incentives,0,0,0,0,0,0,0
LAB North,HN-CBC,2025,CSD,Pepsi,STB - Push,Trade Programs,Innovation Investments,0,0,0,0,0,0,0
LAB North,HN-CBC,2025,CSD,Pepsi,STB - Push,Trade Programs,Sales Incentives,50,2582510,1291255,1291255,99892,49946,49946
LAB North,HN-CBC,2025,CSD,Pepsi,STB - Push,Trade Programs,Space Investments,0,0,0,0,0,0,0
LAB North,HN-CBC,2025,CSD,Pepsi,Pull-Working,All Other Working,Other Working - PR execution,50,651275,325637,325638,25191,12595,12596
LAB North,HN-CBC,2025,CSD,Pepsi,Pull-Working,All Other Working,Other Working - activation,0,0,0,0,0,0,0
LAB North,HN-CBC,2025,CSD,Pepsi,Pull-Working,All Other Working,Other Working - non allocated working,0,0,0,0,0,0,0
LAB North,HN-CBC,2025,CSD,Pepsi,Pull-Working,Consumer Promotions,Consumer Promotions Execution,50,6915307,3457653,3457654,267485,133742,133743
LAB North,HN-CBC,2025,CSD,Pepsi,Pull-Working,Consumer Promotions,Coupons,0,0,0,0,0,0,0
LAB North,HN-CBC,2025,CSD,Pepsi,Pull-Working,Consumer Promotions,Other,0,0,0,0,0,0,0
LAB North,HN-CBC,2025,CSD,Pepsi,Pull-Working,Consumer Promotions,Premiums,50,3226752,1613376,1613376,124811,62405,62406
LAB North,HN-CBC,2025,CSD,Pepsi,Pull-Working,In Store & POS Execution,In-Store & POS Execution,50,13107218,6553609,6553609,506989,253494,253495
LAB North,HN-CBC,2025,CSD,Pepsi,Pull-Working,Media Placements,Cinema,50,661172,330586,330586,25574,12787,12787
LAB North,HN-CBC,2025,CSD,Pepsi,Pull-Working,Media Placements,Digital,50,17590308,8795154,8795154,680396,340198,340198
LAB North,HN-CBC,2025,CSD,Pepsi,Pull-Working,Media Placements,OOH - Out Of Home,50,11104817,5552408,5552409,429536,214768,214768
LAB North,HN-CBC,2025,CSD,Pepsi,Pull-Working,Media Placements,Other,50,1000001,500000,500001,38680,19340,19340
LAB North,HN-CBC,2025,CSD,Pepsi,Pull-Working,Media Placements,Print,0,0,0,0,0,0,0
LAB North,HN-CBC,2025,CSD,Pepsi,Pull-Working,Media Placements,Radio,50,1346666,673333,673333,52089,26044,26045
LAB North,HN-CBC,2025,CSD,Pepsi,Pull-Working,Media Placements,TV,50,6523118,3261559,3261559,252315,126157,126158
LAB North,HN-CBC,2025,CSD,Pepsi,Pull-Working,Sampling,Product Samples,50,209998,104999,104999,8122,4061,4061
LAB North,HN-CBC,2025,CSD,Pepsi,Pull-Working,Sampling,Sampling Execution,50,1240411,620205,620206,47979,23989,23990
LAB North,HN-CBC,2025,CSD,Pepsi,Pull-Working,Sponsorships,Sponsorships-in game/ in show,50,11694133,5847066,5847067,452331,226165,226166
LAB North,HN-CBC,2025,CSD,Pepsi,Pull-Working,Sponsorships,Sports-athlete/team contracts,50,3414863,1707431,1707432,132087,66043,66044
LAB North,HN-CBC,2025,CSD,Pepsi,Pull-Working,Sponsorships,Sports-on field or in show props,0,0,0,0,0,0,0
LAB North,HN-CBC,2025,CSD,Pepsi,Pull-Working,Sponsorships,Sports-stadium contracts,0,0,0,0,0,0,0
LAB North,Jamaica,2025,Energy Drinks,Adrenaline,Pull-Non-Working,Ad Production,Digital Ad Production,0,0,0,0,0,0,0
LAB North,Jamaica,2025,Energy Drinks,Adrenaline,Pull-Non-Working,Ad Production,"TV, Print, Radio, OOH, Production",50,1949,974,975,12,6,6
LAB North,Jamaica,2025,Energy Drinks,Adrenaline,Pull-Non-Working,Agency Fees,Creative Agency Fees,0,0,0,0,0,0,0
LAB North,Jamaica,2025,Energy Drinks,Adrenaline,Pull-Non-Working,Agency Fees,In Store & POS Design / Development,0,0,0,0,0,0,0
LAB North,Jamaica,2025,Energy Drinks,Adrenaline,Pull-Non-Working,Agency Fees,Media Agency Fees,0,0,0,0,0,0,0
LAB North,Jamaica,2025,Energy Drinks,Adrenaline,Pull-Non-Working,Agency Fees,Other,0,0,0,0,0,0,0
LAB North,Jamaica,2025,Energy Drinks,Adrenaline,Pull-Non-Working,Agency Fees,Social Media / Influence Marketing,50,13649,6824,6825,86,43,43
LAB North,Jamaica,2025,Energy Drinks,Adrenaline,Pull-Non-Working,All Other Non-Working,Administrative fees,0,0,0,0,0,0,0
LAB North,Jamaica,2025,Energy Drinks,Adrenaline,Pull-Non-Working,All Other Non-Working,Agency out of pocket,0,0,0,0,0,0,0
LAB North,Jamaica,2025,Energy Drinks,Adrenaline,Pull-Non-Working,All Other Non-Working,CP out of pocket admin,0,0,0,0,0,0,0
LAB North,Jamaica,2025,Energy Drinks,Adrenaline,Pull-Non-Working,All Other Non-Working,Grassroots/experiential out of pocket,0,0,0,0,0,0,0
LAB North,Jamaica,2025,Energy Drinks,Adrenaline,Pull-Non-Working,All Other Non-Working,League/property- rights fee/options,0,0,0,0,0,0,0
LAB North,Jamaica,2025,Energy Drinks,Adrenaline,Pull-Non-Working,All Other Non-Working,Market Research,0,0,0,0,0,0,0
LAB North,Jamaica,2025,Energy Drinks,Adrenaline,Pull-Non-Working,All Other Non-Working,Non-allocated NW,0,0,0,0,0,0,0
LAB North,Jamaica,2025,Energy Drinks,Adrenaline,Pull-Non-Working,All Other Non-Working,Other Non Working-non itemised talent,0,0,0,0,0,0,0
LAB North,Jamaica,2025,Energy Drinks,Adrenaline,Pull-Non-Working,All Other Non-Working,PR out of pocket administrative,0,0,0,0,0,0,0
LAB North,Jamaica,2025,Energy Drinks,Adrenaline,Pull-Non-Working,Innovation and Insight,Innovations,0,0,0,0,0,0,0
LAB North,Jamaica,2025,Energy Drinks,Adrenaline,Pull-Non-Working,Innovation and Insight,Market Research,50,3899,1949,1950,24,12,12
LAB North,Jamaica,2025,Energy Drinks,Adrenaline,Pull-Non-Working,Package Design,Package design,0,0,0,0,0,0,0
LAB North,Jamaica,2025,Energy Drinks,Adrenaline,Pull-Non-Working,Package Design,Package development,0,0,0,0,0,0,0
LAB North,Jamaica,2025,Energy Drinks,Adrenaline,STB - Push,Capability Building/Other,Capability Building Other,0,0,0,0,0,0,0
LAB North,Jamaica,2025,Energy Drinks,Adrenaline,STB - Push,Other Investments,CDA's,0,0,0,0,0,0,0
LAB North,Jamaica,2025,Energy Drinks,Adrenaline,STB - Push,Other Investments,Capital (Coolers),0,0,0,0,0,0,0
LAB North,Jamaica,2025,Energy Drinks,Adrenaline,STB - Push,Other Investments,Price Support,50,677049,338524,338525,4305,2152,2153
LAB North,Jamaica,2025,Energy Drinks,Adrenaline,STB - Push,Other Investments,Vending / Racks,0,0,0,0,0,0,0
LAB North,Jamaica,2025,Energy Drinks,Adrenaline,STB - Push,Other Trade,Frozen Funds,0,0,0,0,0,0,0
LAB North,Jamaica,2025,Energy Drinks,Adrenaline,STB - Push,Other Trade,Other Trade,0,0,0,0,0,0,0
LAB North,Jamaica,2025,Energy Drinks,Adrenaline,STB - Push,Trade Equipment,Coolers - New,0,0,0,0,0,0,0
LAB North,Jamaica,2025,Energy Drinks,Adrenaline,STB - Push,Trade Equipment,Coolers - Refurbished,0,0,0,0,0,0,0
LAB North,Jamaica,2025,Energy Drinks,Adrenaline,STB - Push,Trade Equipment,Post Mix / Pre Mix Equip.,0,0,0,0,0,0,0
LAB North,Jamaica,2025,Energy Drinks,Adrenaline,STB - Push,Trade Equipment,Vending / Racks,0,0,0,0,0,0,0
LAB North,Jamaica,2025,Energy Drinks,Adrenaline,STB - Push,Trade Programs,Distribution Incentives,0,0,0,0,0,0,0
LAB North,Jamaica,2025,Energy Drinks,Adrenaline,STB - Push,Trade Programs,Innovation Investments,0,0,0,0,0,0,0
LAB North,Jamaica,2025,Energy Drinks,Adrenaline,STB - Push,Trade Programs,Sales Incentives,0,0,0,0,0,0,0
LAB North,Jamaica,2025,Energy Drinks,Adrenaline,STB - Push,Trade Programs,Space Investments,0,0,0,0,0,0,0
LAB North,Jamaica,2025,Energy Drinks,Adrenaline,Pull-Working,All Other Working,Other Working - PR execution,0,0,0,0,0,0,0
LAB North,Jamaica,2025,Energy Drinks,Adrenaline,Pull-Working,All Other Working,Other Working - activation,0,0,0,0,0,0,0
LAB North,Jamaica,2025,Energy Drinks,Adrenaline,Pull-Working,All Other Working,Other Working - non allocated working,0,0,0,0,0,0,0
LAB North,Jamaica,2025,Energy Drinks,Adrenaline,Pull-Working,Consumer Promotions,Consumer Promotions Execution,0,0,0,0,0,0,0
LAB North,Jamaica,2025,Energy Drinks,Adrenaline,Pull-Working,Consumer Promotions,Coupons,0,0,0,0,0,0,0
LAB North,Jamaica,2025,Energy Drinks,Adrenaline,Pull-Working,Consumer Promotions,Other,0,0,0,0,0,0,0
LAB North,Jamaica,2025,Energy Drinks,Adrenaline,Pull-Working,Consumer Promotions,Premiums,0,0,0,0,0,0,0
LAB North,Jamaica,2025,Energy Drinks,Adrenaline,Pull-Working,In Store & POS Execution,In-Store & POS Execution,50,17916,8958,8958,113,56,57
LAB North,Jamaica,2025,Energy Drinks,Adrenaline,Pull-Working,Media Placements,Cinema,0,0,0,0,0,0,0
LAB North,Jamaica,2025,Energy Drinks,Adrenaline,Pull-Working,Media Placements,Digital,50,37950,18975,18975,241,120,121
LAB North,Jamaica,2025,Energy Drinks,Adrenaline,Pull-Working,Media Placements,OOH - Out Of Home,50,21504,10752,10752,136,68,68
LAB North,Jamaica,2025,Energy Drinks,Adrenaline,Pull-Working,Media Placements,Other,0,0,0,0,0,0,0
LAB North,Jamaica,2025,Energy Drinks,Adrenaline,Pull-Working,Media Placements,Print,0,0,0,0,0,0,0
LAB North,Jamaica,2025,Energy Drinks,Adrenaline,Pull-Working,Media Placements,Radio,50,31624,15812,15812,201,100,101
LAB North,Jamaica,2025,Energy Drinks,Adrenaline,Pull-Working,Media Placements,TV,0,0,0,0,0,0,0
LAB North,Jamaica,2025,Energy Drinks,Adrenaline,Pull-Working,Sampling,Product Samples,0,0,0,0,0,0,0
LAB North,Jamaica,2025,Energy Drinks,Adrenaline,Pull-Working,Sampling,Sampling Execution,0,0,0,0,0,0,0
LAB North,Jamaica,2025,Energy Drinks,Adrenaline,Pull-Working,Sponsorships,Sponsorships-in game/ in show,50,35419,17709,17710,225,112,113
LAB North,Jamaica,2025,Energy Drinks,Adrenaline,Pull-Working,Sponsorships,Sports-athlete/team contracts,0,0,0,0,0,0,0
LAB North,Jamaica,2025,Energy Drinks,Adrenaline,Pull-Working,Sponsorships,Sports-on field or in show props,0,0,0,0,0,0,0
LAB North,Jamaica,2025,Energy Drinks,Adrenaline,Pull-Working,Sponsorships,Sports-stadium contracts,0,0,0,0,0,0,0
LAB North,Jamaica,2025,CSD,D&G,Pull-Non-Working,Ad Production,Digital Ad Production,0,0,0,0,0,0,0
LAB North,Jamaica,2025,CSD,D&G,Pull-Non-Working,Ad Production,"TV, Print, Radio, OOH, Production",0,0,0,0,0,0,0
LAB North,Jamaica,2025,CSD,D&G,Pull-Non-Working,Agency Fees,Creative Agency Fees,0,0,0,0,0,0,0
LAB North,Jamaica,2025,CSD,D&G,Pull-Non-Working,Agency Fees,In Store & POS Design / Development,0,0,0,0,0,0,0
LAB North,Jamaica,2025,CSD,D&G,Pull-Non-Working,Agency Fees,Media Agency Fees,0,0,0,0,0,0,0
LAB North,Jamaica,2025,CSD,D&G,Pull-Non-Working,Agency Fees,Other,0,0,0,0,0,0,0
LAB North,Jamaica,2025,CSD,D&G,Pull-Non-Working,Agency Fees,Social Media / Influence Marketing,0,0,0,0,0,0,0
LAB North,Jamaica,2025,CSD,D&G,Pull-Non-Working,All Other Non-Working,Administrative fees,0,0,0,0,0,0,0
LAB North,Jamaica,2025,CSD,D&G,Pull-Non-Working,All Other Non-Working,Agency out of pocket,0,0,0,0,0,0,0
LAB North,Jamaica,2025,CSD,D&G,Pull-Non-Working,All Other Non-Working,CP out of pocket admin,0,0,0,0,0,0,0
LAB North,Jamaica,2025,CSD,D&G,Pull-Non-Working,All Other Non-Working,Grassroots/experiential out of pocket,0,0,0,0,0,0,0
LAB North,Jamaica,2025,CSD,D&G,Pull-Non-Working,All Other Non-Working,League/property- rights fee/options,0,0,0,0,0,0,0
LAB North,Jamaica,2025,CSD,D&G,Pull-Non-Working,All Other Non-Working,Market Research,0,0,0,0,0,0,0
LAB North,Jamaica,2025,CSD,D&G,Pull-Non-Working,All Other Non-Working,Non-allocated NW,0,0,0,0,0,0,0
LAB North,Jamaica,2025,CSD,D&G,Pull-Non-Working,All Other Non-Working,Other Non Working-non itemised talent,0,0,0,0,0,0,0
LAB North,Jamaica,2025,CSD,D&G,Pull-Non-Working,All Other Non-Working,PR out of pocket administrative,0,0,0,0,0,0,0
LAB North,Jamaica,2025,CSD,D&G,Pull-Non-Working,Innovation and Insight,Innovations,0,0,0,0,0,0,0
LAB North,Jamaica,2025,CSD,D&G,Pull-Non-Working,Innovation and Insight,Market Research,0,0,0,0,0,0,0
LAB North,Jamaica,2025,CSD,D&G,Pull-Non-Working,Package Design,Package design,0,0,0,0,0,0,0
LAB North,Jamaica,2025,CSD,D&G,Pull-Non-Working,Package Design,Package development,0,0,0,0,0,0,0
LAB North,Jamaica,2025,CSD,D&G,STB - Push,Capability Building/Other,Capability Building Other,0,0,0,0,0,0,0
LAB North,Jamaica,2025,CSD,D&G,STB - Push,Other Investments,CDA's,0,0,0,0,0,0,0
LAB North,Jamaica,2025,CSD,D&G,STB - Push,Other Investments,Capital (Coolers),0,0,0,0,0,0,0
LAB North,Jamaica,2025,CSD,D&G,STB - Push,Other Investments,Price Support,50,411498,205749,205749,2616,1308,1308
LAB North,Jamaica,2025,CSD,D&G,STB - Push,Other Investments,Vending / Racks,0,0,0,0,0,0,0
LAB North,Jamaica,2025,CSD,D&G,STB - Push,Other Trade,Frozen Funds,0,0,0,0,0,0,0
LAB North,Jamaica,2025,CSD,D&G,STB - Push,Other Trade,Other Trade,0,0,0,0,0,0,0
LAB North,Jamaica,2025,CSD,D&G,STB - Push,Trade Equipment,Coolers - New,0,0,0,0,0,0,0
LAB North,Jamaica,2025,CSD,D&G,STB - Push,Trade Equipment,Coolers - Refurbished,0,0,0,0,0,0,0
LAB North,Jamaica,2025,CSD,D&G,STB - Push,Trade Equipment,Post Mix / Pre Mix Equip.,0,0,0,0,0,0,0
LAB North,Jamaica,2025,CSD,D&G,STB - Push,Trade Equipment,Vending / Racks,0,0,0,0,0,0,0
LAB North,Jamaica,2025,CSD,D&G,STB - Push,Trade Programs,Distribution Incentives,0,0,0,0,0,0,0
LAB North,Jamaica,2025,CSD,D&G,STB - Push,Trade Programs,Innovation Investments,0,0,0,0,0,0,0
LAB North,Jamaica,2025,CSD,D&G,STB - Push,Trade Programs,Sales Incentives,0,0,0,0,0,0,0
LAB North,Jamaica,2025,CSD,D&G,STB - Push,Trade Programs,Space Investments,0,0,0,0,0,0,0
LAB North,Jamaica,2025,CSD,D&G,Pull-Working,All Other Working,Other Working - PR execution,0,0,0,0,0,0,0
LAB North,Jamaica,2025,CSD,D&G,Pull-Working,All Other Working,Other Working - activation,0,0,0,0,0,0,0
LAB North,Jamaica,2025,CSD,D&G,Pull-Working,All Other Working,Other Working - non allocated working,0,0,0,0,0,0,0
LAB North,Jamaica,2025,CSD,D&G,Pull-Working,Consumer Promotions,Consumer Promotions Execution,0,0,0,0,0,0,0
LAB North,Jamaica,2025,CSD,D&G,Pull-Working,Consumer Promotions,Coupons,0,0,0,0,0,0,0
LAB North,Jamaica,2025,CSD,D&G,Pull-Working,Consumer Promotions,Other,0,0,0,0,0,0,0
LAB North,Jamaica,2025,CSD,D&G,Pull-Working,Consumer Promotions,Premiums,0,0,0,0,0,0,0
LAB North,Jamaica,2025,CSD,D&G,Pull-Working,In Store & POS Execution,In-Store & POS Execution,0,0,0,0,0,0,0
LAB North,Jamaica,2025,CSD,D&G,Pull-Working,Media Placements,Cinema,0,0,0,0,0,0,0
LAB North,Jamaica,2025,CSD,D&G,Pull-Working,Media Placements,Digital,0,0,0,0,0,0,0
LAB North,Jamaica,2025,CSD,D&G,Pull-Working,Media Placements,OOH - Out Of Home,0,0,0,0,0,0,0
LAB North,Jamaica,2025,CSD,D&G,Pull-Working,Media Placements,Other,0,0,0,0,0,0,0
LAB North,Jamaica,2025,CSD,D&G,Pull-Working,Media Placements,Print,0,0,0,0,0,0,0
LAB North,Jamaica,2025,CSD,D&G,Pull-Working,Media Placements,Radio,0,0,0,0,0,0,0
LAB North,Jamaica,2025,CSD,D&G,Pull-Working,Media Placements,TV,0,0,0,0,0,0,0
LAB North,Jamaica,2025,CSD,D&G,Pull-Working,Sampling,Product Samples,0,0,0,0,0,0,0
LAB North,Jamaica,2025,CSD,D&G,Pull-Working,Sampling,Sampling Execution,0,0,0,0,0,0,0
LAB North,Jamaica,2025,CSD,D&G,Pull-Working,Sponsorships,Sponsorships-in game/ in show,0,0,0,0,0,0,0
LAB North,Jamaica,2025,CSD,D&G,Pull-Working,Sponsorships,Sports-athlete/team contracts,0,0,0,0,0,0,0
LAB North,Jamaica,2025,CSD,D&G,Pull-Working,Sponsorships,Sports-on field or in show props,0,0,0,0,0,0,0
LAB North,Jamaica,2025,CSD,D&G,Pull-Working,Sponsorships,Sports-stadium contracts,0,0,0,0,0,0,0
LAB North,Jamaica,2025,Sport Drinks,Gatorade,Pull-Non-Working,Ad Production,Digital Ad Production,50,14960,7480,7480,95,47,48
LAB North,Jamaica,2025,Sport Drinks,Gatorade,Pull-Non-Working,Ad Production,"TV, Print, Radio, OOH, Production",0,0,0,0,0,0,0
LAB North,Jamaica,2025,Sport Drinks,Gatorade,Pull-Non-Working,Agency Fees,Creative Agency Fees,0,0,0,0,0,0,0
LAB North,Jamaica,2025,Sport Drinks,Gatorade,Pull-Non-Working,Agency Fees,In Store & POS Design / Development,0,0,0,0,0,0,0
LAB North,Jamaica,2025,Sport Drinks,Gatorade,Pull-Non-Working,Agency Fees,Media Agency Fees,0,0,0,0,0,0,0
LAB North,Jamaica,2025,Sport Drinks,Gatorade,Pull-Non-Working,Agency Fees,Other,0,0,0,0,0,0,0
LAB North,Jamaica,2025,Sport Drinks,Gatorade,Pull-Non-Working,Agency Fees,Social Media / Influence Marketing,50,63359,31679,31680,402,201,201
LAB North,Jamaica,2025,Sport Drinks,Gatorade,Pull-Non-Working,All Other Non-Working,Administrative fees,0,0,0,0,0,0,0
LAB North,Jamaica,2025,Sport Drinks,Gatorade,Pull-Non-Working,All Other Non-Working,Agency out of pocket,0,0,0,0,0,0,0
LAB North,Jamaica,2025,Sport Drinks,Gatorade,Pull-Non-Working,All Other Non-Working,CP out of pocket admin,0,0,0,0,0,0,0
LAB North,Jamaica,2025,Sport Drinks,Gatorade,Pull-Non-Working,All Other Non-Working,Grassroots/experiential out of pocket,0,0,0,0,0,0,0
LAB North,Jamaica,2025,Sport Drinks,Gatorade,Pull-Non-Working,All Other Non-Working,League/property- rights fee/options,0,0,0,0,0,0,0
LAB North,Jamaica,2025,Sport Drinks,Gatorade,Pull-Non-Working,All Other Non-Working,Market Research,0,0,0,0,0,0,0
LAB North,Jamaica,2025,Sport Drinks,Gatorade,Pull-Non-Working,All Other Non-Working,Non-allocated NW,0,0,0,0,0,0,0
LAB North,Jamaica,2025,Sport Drinks,Gatorade,Pull-Non-Working,All Other Non-Working,Other Non Working-non itemised talent,0,0,0,0,0,0,0
LAB North,Jamaica,2025,Sport Drinks,Gatorade,Pull-Non-Working,All Other Non-Working,PR out of pocket administrative,0,0,0,0,0,0,0
LAB North,Jamaica,2025,Sport Drinks,Gatorade,Pull-Non-Working,Innovation and Insight,Innovations,0,0,0,0,0,0,0
LAB North,Jamaica,2025,Sport Drinks,Gatorade,Pull-Non-Working,Innovation and Insight,Market Research,50,9680,4840,4840,61,30,31
LAB North,Jamaica,2025,Sport Drinks,Gatorade,Pull-Non-Working,Package Design,Package design,0,0,0,0,0,0,0
LAB North,Jamaica,2025,Sport Drinks,Gatorade,Pull-Non-Working,Package Design,Package development,0,0,0,0,0,0,0
LAB North,Jamaica,2025,Sport Drinks,Gatorade,STB - Push,Capability Building/Other,Capability Building Other,0,0,0,0,0,0,0
LAB North,Jamaica,2025,Sport Drinks,Gatorade,STB - Push,Other Investments,CDA's,0,0,0,0,0,0,0
LAB North,Jamaica,2025,Sport Drinks,Gatorade,STB - Push,Other Investments,Capital (Coolers),0,0,0,0,0,0,0
LAB North,Jamaica,2025,Sport Drinks,Gatorade,STB - Push,Other Investments,Price Support,50,721777,360888,360889,4589,2294,2295
LAB North,Jamaica,2025,Sport Drinks,Gatorade,STB - Push,Other Investments,Vending / Racks,0,0,0,0,0,0,0
LAB North,Jamaica,2025,Sport Drinks,Gatorade,STB - Push,Other Trade,Frozen Funds,0,0,0,0,0,0,0
LAB North,Jamaica,2025,Sport Drinks,Gatorade,STB - Push,Other Trade,Other Trade,0,0,0,0,0,0,0
LAB North,Jamaica,2025,Sport Drinks,Gatorade,STB - Push,Trade Equipment,Coolers - New,0,0,0,0,0,0,0
LAB North,Jamaica,2025,Sport Drinks,Gatorade,STB - Push,Trade Equipment,Coolers - Refurbished,0,0,0,0,0,0,0
LAB North,Jamaica,2025,Sport Drinks,Gatorade,STB - Push,Trade Equipment,Post Mix / Pre Mix Equip.,0,0,0,0,0,0,0
LAB North,Jamaica,2025,Sport Drinks,Gatorade,STB - Push,Trade Equipment,Vending / Racks,0,0,0,0,0,0,0
LAB North,Jamaica,2025,Sport Drinks,Gatorade,STB - Push,Trade Programs,Distribution Incentives,50,156710,78355,78355,996,498,498
LAB North,Jamaica,2025,Sport Drinks,Gatorade,STB - Push,Trade Programs,Innovation Investments,0,0,0,0,0,0,0
LAB North,Jamaica,2025,Sport Drinks,Gatorade,STB - Push,Trade Programs,Sales Incentives,50,181247,90623,90624,1152,576,576
LAB North,Jamaica,2025,Sport Drinks,Gatorade,STB - Push,Trade Programs,Space Investments,50,101076,50538,50538,642,321,321
LAB North,Jamaica,2025,Sport Drinks,Gatorade,Pull-Working,All Other Working,Other Working - PR execution,50,12359,6179,6180,78,39,39
LAB North,Jamaica,2025,Sport Drinks,Gatorade,Pull-Working,All Other Working,Other Working - activation,0,0,0,0,0,0,0
LAB North,Jamaica,2025,Sport Drinks,Gatorade,Pull-Working,All Other Working,Other Working - non allocated working,0,0,0,0,0,0,0
LAB North,Jamaica,2025,Sport Drinks,Gatorade,Pull-Working,Consumer Promotions,Consumer Promotions Execution,50,49440,24720,24720,314,157,157
LAB North,Jamaica,2025,Sport Drinks,Gatorade,Pull-Working,Consumer Promotions,Coupons,0,0,0,0,0,0,0
LAB North,Jamaica,2025,Sport Drinks,Gatorade,Pull-Working,Consumer Promotions,Other,0,0,0,0,0,0,0
LAB North,Jamaica,2025,Sport Drinks,Gatorade,Pull-Working,Consumer Promotions,Premiums,50,16480,8240,8240,104,52,52
LAB North,Jamaica,2025,Sport Drinks,Gatorade,Pull-Working,In Store & POS Execution,In-Store & POS Execution,50,45188,22594,22594,287,143,144
LAB North,Jamaica,2025,Sport Drinks,Gatorade,Pull-Working,Media Placements,Cinema,0,0,0,0,0,0,0
LAB North,Jamaica,2025,Sport Drinks,Gatorade,Pull-Working,Media Placements,Digital,50,119480,59740,59740,759,379,380
LAB North,Jamaica,2025,Sport Drinks,Gatorade,Pull-Working,Media Placements,OOH - Out Of Home,50,16480,8240,8240,104,52,52
LAB North,Jamaica,2025,Sport Drinks,Gatorade,Pull-Working,Media Placements,Other,0,0,0,0,0,0,0
LAB North,Jamaica,2025,Sport Drinks,Gatorade,Pull-Working,Media Placements,Print,0,0,0,0,0,0,0
LAB North,Jamaica,2025,Sport Drinks,Gatorade,Pull-Working,Media Placements,Radio,50,65920,32960,32960,419,209,210
LAB North,Jamaica,2025,Sport Drinks,Gatorade,Pull-Working,Media Placements,TV,0,0,0,0,0,0,0
LAB North,Jamaica,2025,Sport Drinks,Gatorade,Pull-Working,Sampling,Product Samples,0,0,0,0,0,0,0
LAB North,Jamaica,2025,Sport Drinks,Gatorade,Pull-Working,Sampling,Sampling Execution,0,0,0,0,0,0,0
LAB North,Jamaica,2025,Sport Drinks,Gatorade,Pull-Working,Sponsorships,Sponsorships-in game/ in show,50,131839,65919,65920,838,419,419
LAB North,Jamaica,2025,Sport Drinks,Gatorade,Pull-Working,Sponsorships,Sports-athlete/team contracts,0,0,0,0,0,0,0
LAB North,Jamaica,2025,Sport Drinks,Gatorade,Pull-Working,Sponsorships,Sports-on field or in show props,0,0,0,0,0,0,0
LAB North,Jamaica,2025,Sport Drinks,Gatorade,Pull-Working,Sponsorships,Sports-stadium contracts,0,0,0,0,0,0,0
LAB North,Jamaica,2025,Juices,Ocean Spray,Pull-Non-Working,Ad Production,Digital Ad Production,0,0,0,0,0,0,0
LAB North,Jamaica,2025,Juices,Ocean Spray,Pull-Non-Working,Ad Production,"TV, Print, Radio, OOH, Production",0,0,0,0,0,0,0
LAB North,Jamaica,2025,Juices,Ocean Spray,Pull-Non-Working,Agency Fees,Creative Agency Fees,0,0,0,0,0,0,0
LAB North,Jamaica,2025,Juices,Ocean Spray,Pull-Non-Working,Agency Fees,In Store & POS Design / Development,0,0,0,0,0,0,0
LAB North,Jamaica,2025,Juices,Ocean Spray,Pull-Non-Working,Agency Fees,Media Agency Fees,0,0,0,0,0,0,0
LAB North,Jamaica,2025,Juices,Ocean Spray,Pull-Non-Working,Agency Fees,Other,0,0,0,0,0,0,0
LAB North,Jamaica,2025,Juices,Ocean Spray,Pull-Non-Working,Agency Fees,Social Media / Influence Marketing,50,7000,3500,3500,44,22,22
LAB North,Jamaica,2025,Juices,Ocean Spray,Pull-Non-Working,All Other Non-Working,Administrative fees,0,0,0,0,0,0,0
LAB North,Jamaica,2025,Juices,Ocean Spray,Pull-Non-Working,All Other Non-Working,Agency out of pocket,0,0,0,0,0,0,0
LAB North,Jamaica,2025,Juices,Ocean Spray,Pull-Non-Working,All Other Non-Working,CP out of pocket admin,0,0,0,0,0,0,0
LAB North,Jamaica,2025,Juices,Ocean Spray,Pull-Non-Working,All Other Non-Working,Grassroots/experiential out of pocket,0,0,0,0,0,0,0
LAB North,Jamaica,2025,Juices,Ocean Spray,Pull-Non-Working,All Other Non-Working,League/property- rights fee/options,0,0,0,0,0,0,0
LAB North,Jamaica,2025,Juices,Ocean Spray,Pull-Non-Working,All Other Non-Working,Market Research,0,0,0,0,0,0,0
LAB North,Jamaica,2025,Juices,Ocean Spray,Pull-Non-Working,All Other Non-Working,Non-allocated NW,0,0,0,0,0,0,0
LAB North,Jamaica,2025,Juices,Ocean Spray,Pull-Non-Working,All Other Non-Working,Other Non Working-non itemised talent,0,0,0,0,0,0,0
LAB North,Jamaica,2025,Juices,Ocean Spray,Pull-Non-Working,All Other Non-Working,PR out of pocket administrative,0,0,0,0,0,0,0
LAB North,Jamaica,2025,Juices,Ocean Spray,Pull-Non-Working,Innovation and Insight,Innovations,0,0,0,0,0,0,0
LAB North,Jamaica,2025,Juices,Ocean Spray,Pull-Non-Working,Innovation and Insight,Market Research,50,13000,6500,6500,82,41,41
LAB North,Jamaica,2025,Juices,Ocean Spray,Pull-Non-Working,Package Design,Package design,0,0,0,0,0,0,0
LAB North,Jamaica,2025,Juices,Ocean Spray,Pull-Non-Working,Package Design,Package development,0,0,0,0,0,0,0
LAB North,Jamaica,2025,Juices,Ocean Spray,STB - Push,Capability Building/Other,Capability Building Other,0,0,0,0,0,0,0
LAB North,Jamaica,2025,Juices,Ocean Spray,STB - Push,Other Investments,CDA's,0,0,0,0,0,0,0
LAB North,Jamaica,2025,Juices,Ocean Spray,STB - Push,Other Investments,Capital (Coolers),0,0,0,0,0,0,0
LAB North,Jamaica,2025,Juices,Ocean Spray,STB - Push,Other Investments,Price Support,50,754137,377068,377069,4795,2397,2398
LAB North,Jamaica,2025,Juices,Ocean Spray,STB - Push,Other Investments,Vending / Racks,0,0,0,0,0,0,0
LAB North,Jamaica,2025,Juices,Ocean Spray,STB - Push,Other Trade,Frozen Funds,0,0,0,0,0,0,0
LAB North,Jamaica,2025,Juices,Ocean Spray,STB - Push,Other Trade,Other Trade,0,0,0,0,0,0,0
LAB North,Jamaica,2025,Juices,Ocean Spray,STB - Push,Trade Equipment,Coolers - New,0,0,0,0,0,0,0
LAB North,Jamaica,2025,Juices,Ocean Spray,STB - Push,Trade Equipment,Coolers - Refurbished,0,0,0,0,0,0,0
LAB North,Jamaica,2025,Juices,Ocean Spray,STB - Push,Trade Equipment,Post Mix / Pre Mix Equip.,0,0,0,0,0,0,0
LAB North,Jamaica,2025,Juices,Ocean Spray,STB - Push,Trade Equipment,Vending / Racks,0,0,0,0,0,0,0
LAB North,Jamaica,2025,Juices,Ocean Spray,STB - Push,Trade Programs,Distribution Incentives,50,112238,56119,56119,713,356,357
LAB North,Jamaica,2025,Juices,Ocean Spray,STB - Push,Trade Programs,Innovation Investments,0,0,0,0,0,0,0
LAB North,Jamaica,2025,Juices,Ocean Spray,STB - Push,Trade Programs,Sales Incentives,0,0,0,0,0,0,0
LAB North,Jamaica,2025,Juices,Ocean Spray,STB - Push,Trade Programs,Space Investments,50,64014,32007,32007,407,203,204
LAB North,Jamaica,2025,Juices,Ocean Spray,Pull-Working,All Other Working,Other Working - PR execution,0,0,0,0,0,0,0
LAB North,Jamaica,2025,Juices,Ocean Spray,Pull-Working,All Other Working,Other Working - activation,0,0,0,0,0,0,0
LAB North,Jamaica,2025,Juices,Ocean Spray,Pull-Working,All Other Working,Other Working - non allocated working,0,0,0,0,0,0,0
LAB North,Jamaica,2025,Juices,Ocean Spray,Pull-Working,Consumer Promotions,Consumer Promotions Execution,0,0,0,0,0,0,0
LAB North,Jamaica,2025,Juices,Ocean Spray,Pull-Working,Consumer Promotions,Coupons,0,0,0,0,0,0,0
LAB North,Jamaica,2025,Juices,Ocean Spray,Pull-Working,Consumer Promotions,Other,0,0,0,0,0,0,0
LAB North,Jamaica,2025,Juices,Ocean Spray,Pull-Working,Consumer Promotions,Premiums,0,0,0,0,0,0,0
LAB North,Jamaica,2025,Juices,Ocean Spray,Pull-Working,In Store & POS Execution,In-Store & POS Execution,50,23888,11944,11944,151,75,76
LAB North,Jamaica,2025,Juices,Ocean Spray,Pull-Working,Media Placements,Cinema,0,0,0,0,0,0,0
LAB North,Jamaica,2025,Juices,Ocean Spray,Pull-Working,Media Placements,Digital,50,44099,22049,22050,280,140,140
LAB North,Jamaica,2025,Juices,Ocean Spray,Pull-Working,Media Placements,OOH - Out Of Home,0,0,0,0,0,0,0
LAB North,Jamaica,2025,Juices,Ocean Spray,Pull-Working,Media Placements,Other,0,0,0,0,0,0,0
LAB North,Jamaica,2025,Juices,Ocean Spray,Pull-Working,Media Placements,Print,0,0,0,0,0,0,0
LAB North,Jamaica,2025,Juices,Ocean Spray,Pull-Working,Media Placements,Radio,50,13300,6650,6650,84,42,42
LAB North,Jamaica,2025,Juices,Ocean Spray,Pull-Working,Media Placements,TV,0,0,0,0,0,0,0
LAB North,Jamaica,2025,Juices,Ocean Spray,Pull-Working,Sampling,Product Samples,50,10500,5250,5250,66,33,33
LAB North,Jamaica,2025,Juices,Ocean Spray,Pull-Working,Sampling,Sampling Execution,50,2099,1049,1050,13,6,7
LAB North,Jamaica,2025,Juices,Ocean Spray,Pull-Working,Sponsorships,Sponsorships-in game/ in show,0,0,0,0,0,0,0
LAB North,Jamaica,2025,Juices,Ocean Spray,Pull-Working,Sponsorships,Sports-athlete/team contracts,0,0,0,0,0,0,0
LAB North,Jamaica,2025,Juices,Ocean Spray,Pull-Working,Sponsorships,Sports-on field or in show props,0,0,0,0,0,0,0
LAB North,Jamaica,2025,Juices,Ocean Spray,Pull-Working,Sponsorships,Sports-stadium contracts,0,0,0,0,0,0,0
LAB North,Jamaica,2025,CSD,Pepsi,Pull-Non-Working,Ad Production,Digital Ad Production,0,0,0,0,0,0,0
LAB North,Jamaica,2025,CSD,Pepsi,Pull-Non-Working,Ad Production,"TV, Print, Radio, OOH, Production",50,162692,81346,81346,1034,517,517
LAB North,Jamaica,2025,CSD,Pepsi,Pull-Non-Working,Agency Fees,Creative Agency Fees,0,0,0,0,0,0,0
LAB North,Jamaica,2025,CSD,Pepsi,Pull-Non-Working,Agency Fees,In Store & POS Design / Development,0,0,0,0,0,0,0
LAB North,Jamaica,2025,CSD,Pepsi,Pull-Non-Working,Agency Fees,Media Agency Fees,0,0,0,0,0,0,0
LAB North,Jamaica,2025,CSD,Pepsi,Pull-Non-Working,Agency Fees,Other,50,116511,58255,58256,740,370,370
LAB North,Jamaica,2025,CSD,Pepsi,Pull-Non-Working,Agency Fees,Social Media / Influence Marketing,50,63489,31744,31745,403,201,202
LAB North,Jamaica,2025,CSD,Pepsi,Pull-Non-Working,All Other Non-Working,Administrative fees,0,0,0,0,0,0,0
LAB North,Jamaica,2025,CSD,Pepsi,Pull-Non-Working,All Other Non-Working,Agency out of pocket,0,0,0,0,0,0,0
LAB North,Jamaica,2025,CSD,Pepsi,Pull-Non-Working,All Other Non-Working,CP out of pocket admin,0,0,0,0,0,0,0
LAB North,Jamaica,2025,CSD,Pepsi,Pull-Non-Working,All Other Non-Working,Grassroots/experiential out of pocket,0,0,0,0,0,0,0
LAB North,Jamaica,2025,CSD,Pepsi,Pull-Non-Working,All Other Non-Working,League/property- rights fee/options,0,0,0,0,0,0,0
LAB North,Jamaica,2025,CSD,Pepsi,Pull-Non-Working,All Other Non-Working,Market Research,0,0,0,0,0,0,0
LAB North,Jamaica,2025,CSD,Pepsi,Pull-Non-Working,All Other Non-Working,Non-allocated NW,0,0,0,0,0,0,0
LAB North,Jamaica,2025,CSD,Pepsi,Pull-Non-Working,All Other Non-Working,Other Non Working-non itemised talent,0,0,0,0,0,0,0
LAB North,Jamaica,2025,CSD,Pepsi,Pull-Non-Working,All Other Non-Working,PR out of pocket administrative,0,0,0,0,0,0,0
LAB North,Jamaica,2025,CSD,Pepsi,Pull-Non-Working,Innovation and Insight,Innovations,0,0,0,0,0,0,0
LAB North,Jamaica,2025,CSD,Pepsi,Pull-Non-Working,Innovation and Insight,Market Research,50,54117,27058,27059,344,172,172
LAB North,Jamaica,2025,CSD,Pepsi,Pull-Non-Working,Package Design,Package design,0,0,0,0,0,0,0
LAB North,Jamaica,2025,CSD,Pepsi,Pull-Non-Working,Package Design,Package development,0,0,0,0,0,0,0
LAB North,Jamaica,2025,CSD,Pepsi,STB - Push,Capability Building/Other,Capability Building Other,0,0,0,0,0,0,0
LAB North,Jamaica,2025,CSD,Pepsi,STB - Push,Other Investments,CDA's,50,379320,189660,189660,2412,1206,1206
LAB North,Jamaica,2025,CSD,Pepsi,STB - Push,Other Investments,Capital (Coolers),0,0,0,0,0,0,0
LAB North,Jamaica,2025,CSD,Pepsi,STB - Push,Other Investments,Price Support,50,3285446,1642723,1642723,20892,10446,10446
LAB North,Jamaica,2025,CSD,Pepsi,STB - Push,Other Investments,Vending / Racks,0,0,0,0,0,0,0
LAB North,Jamaica,2025,CSD,Pepsi,STB - Push,Other Trade,Frozen Funds,0,0,0,0,0,0,0
LAB North,Jamaica,2025,CSD,Pepsi,STB - Push,Other Trade,Other Trade,50,143336,71668,71668,911,455,456
LAB North,Jamaica,2025,CSD,Pepsi,STB - Push,Trade Equipment,Coolers - New,0,0,0,0,0,0,0
LAB North,Jamaica,2025,CSD,Pepsi,STB - Push,Trade Equipment,Coolers - Refurbished,0,0,0,0,0,0,0
LAB North,Jamaica,2025,CSD,Pepsi,STB - Push,Trade Equipment,Post Mix / Pre Mix Equip.,0,0,0,0,0,0,0
LAB North,Jamaica,2025,CSD,Pepsi,STB - Push,Trade Equipment,Vending / Racks,0,0,0,0,0,0,0
LAB North,Jamaica,2025,CSD,Pepsi,STB - Push,Trade Programs,Distribution Incentives,50,372320,186160,186160,2367,1183,1184
LAB North,Jamaica,2025,CSD,Pepsi,STB - Push,Trade Programs,Innovation Investments,0,0,0,0,0,0,0
LAB North,Jamaica,2025,CSD,Pepsi,STB - Push,Trade Programs,Sales Incentives,50,12952,6476,6476,82,41,41
LAB North,Jamaica,2025,CSD,Pepsi,STB - Push,Trade Programs,Space Investments,50,138136,69068,69068,878,439,439
LAB North,Jamaica,2025,CSD,Pepsi,Pull-Working,All Other Working,Other Working - PR execution,50,82437,41218,41219,524,262,262
LAB North,Jamaica,2025,CSD,Pepsi,Pull-Working,All Other Working,Other Working - activation,50,309139,154569,154570,1965,982,983
LAB North,Jamaica,2025,CSD,Pepsi,Pull-Working,All Other Working,Other Working - non allocated working,0,0,0,0,0,0,0
LAB North,Jamaica,2025,CSD,Pepsi,Pull-Working,Consumer Promotions,Consumer Promotions Execution,0,0,0,0,0,0,0
LAB North,Jamaica,2025,CSD,Pepsi,Pull-Working,Consumer Promotions,Coupons,0,0,0,0,0,0,0
LAB North,Jamaica,2025,CSD,Pepsi,Pull-Working,Consumer Promotions,Other,0,0,0,0,0,0,0
LAB North,Jamaica,2025,CSD,Pepsi,Pull-Working,Consumer Promotions,Premiums,50,61827,30913,30914,393,196,197
LAB North,Jamaica,2025,CSD,Pepsi,Pull-Working,In Store & POS Execution,In-Store & POS Execution,50,275187,137593,137594,1749,874,875
LAB North,Jamaica,2025,CSD,Pepsi,Pull-Working,Media Placements,Cinema,0,0,0,0,0,0,0
LAB North,Jamaica,2025,CSD,Pepsi,Pull-Working,Media Placements,Digital,50,412186,206093,206093,2621,1310,1311
LAB North,Jamaica,2025,CSD,Pepsi,Pull-Working,Media Placements,OOH - Out Of Home,50,267921,133960,133961,1703,851,852
LAB North,Jamaica,2025,CSD,Pepsi,Pull-Working,Media Placements,Other,50,20609,10304,10305,131,65,66
LAB North,Jamaica,2025,CSD,Pepsi,Pull-Working,Media Placements,Print,0,0,0,0,0,0,0
LAB North,Jamaica,2025,CSD,Pepsi,Pull-Working,Media Placements,Radio,50,206093,103046,103047,1310,655,655
LAB North,Jamaica,2025,CSD,Pepsi,Pull-Working,Media Placements,TV,50,329749,164874,164875,2096,1048,1048
LAB North,Jamaica,2025,CSD,Pepsi,Pull-Working,Sampling,Product Samples,50,82437,41218,41219,524,262,262
LAB North,Jamaica,2025,CSD,Pepsi,Pull-Working,Sampling,Sampling Execution,50,82437,41218,41219,524,262,262
LAB North,Jamaica,2025,CSD,Pepsi,Pull-Working,Sponsorships,Sponsorships-in game/ in show,50,123655,61827,61828,786,393,393
LAB North,Jamaica,2025,CSD,Pepsi,Pull-Working,Sponsorships,Sports-athlete/team contracts,50,82437,41218,41219,524,262,262
LAB North,Jamaica,2025,CSD,Pepsi,Pull-Working,Sponsorships,Sports-on field or in show props,0,0,0,0,0,0,0
LAB North,Jamaica,2025,CSD,Pepsi,Pull-Working,Sponsorships,Sports-stadium contracts,0,0,0,0,0,0,0
LAB North,Jamaica,2025,Juices,Tropicana,Pull-Non-Working,Ad Production,Digital Ad Production,50,21339,10669,10670,135,67,68
LAB North,Jamaica,2025,Juices,Tropicana,Pull-Non-Working,Ad Production,"TV, Print, Radio, OOH, Production",0,0,0,0,0,0,0
LAB North,Jamaica,2025,Juices,Tropicana,Pull-Non-Working,Agency Fees,Creative Agency Fees,0,0,0,0,0,0,0
LAB North,Jamaica,2025,Juices,Tropicana,Pull-Non-Working,Agency Fees,In Store & POS Design / Development,0,0,0,0,0,0,0
LAB North,Jamaica,2025,Juices,Tropicana,Pull-Non-Working,Agency Fees,Media Agency Fees,0,0,0,0,0,0,0
LAB North,Jamaica,2025,Juices,Tropicana,Pull-Non-Working,Agency Fees,Other,0,0,0,0,0,0,0
LAB North,Jamaica,2025,Juices,Tropicana,Pull-Non-Working,Agency Fees,Social Media / Influence Marketing,50,59170,29585,29585,376,188,188
LAB North,Jamaica,2025,Juices,Tropicana,Pull-Non-Working,All Other Non-Working,Administrative fees,0,0,0,0,0,0,0
LAB North,Jamaica,2025,Juices,Tropicana,Pull-Non-Working,All Other Non-Working,Agency out of pocket,0,0,0,0,0,0,0
LAB North,Jamaica,2025,Juices,Tropicana,Pull-Non-Working,All Other Non-Working,CP out of pocket admin,0,0,0,0,0,0,0
LAB North,Jamaica,2025,Juices,Tropicana,Pull-Non-Working,All Other Non-Working,Grassroots/experiential out of pocket,0,0,0,0,0,0,0
LAB North,Jamaica,2025,Juices,Tropicana,Pull-Non-Working,All Other Non-Working,League/property- rights fee/options,0,0,0,0,0,0,0
LAB North,Jamaica,2025,Juices,Tropicana,Pull-Non-Working,All Other Non-Working,Market Research,0,0,0,0,0,0,0
LAB North,Jamaica,2025,Juices,Tropicana,Pull-Non-Working,All Other Non-Working,Non-allocated NW,0,0,0,0,0,0,0
LAB North,Jamaica,2025,Juices,Tropicana,Pull-Non-Working,All Other Non-Working,Other Non Working-non itemised talent,0,0,0,0,0,0,0
LAB North,Jamaica,2025,Juices,Tropicana,Pull-Non-Working,All Other Non-Working,PR out of pocket administrative,0,0,0,0,0,0,0
LAB North,Jamaica,2025,Juices,Tropicana,Pull-Non-Working,Innovation and Insight,Innovations,0,0,0,0,0,0,0
LAB North,Jamaica,2025,Juices,Tropicana,Pull-Non-Working,Innovation and Insight,Market Research,50,16489,8244,8245,104,52,52
LAB North,Jamaica,2025,Juices,Tropicana,Pull-Non-Working,Package Design,Package design,0,0,0,0,0,0,0
LAB North,Jamaica,2025,Juices,Tropicana,Pull-Non-Working,Package Design,Package development,0,0,0,0,0,0,0
LAB North,Jamaica,2025,Juices,Tropicana,STB - Push,Capability Building/Other,Capability Building Other,0,0,0,0,0,0,0
LAB North,Jamaica,2025,Juices,Tropicana,STB - Push,Other Investments,CDA's,0,0,0,0,0,0,0
LAB North,Jamaica,2025,Juices,Tropicana,STB - Push,Other Investments,Capital (Coolers),0,0,0,0,0,0,0
LAB North,Jamaica,2025,Juices,Tropicana,STB - Push,Other Investments,Price Support,50,879010,439505,439505,5589,2794,2795
LAB North,Jamaica,2025,Juices,Tropicana,STB - Push,Other Investments,Vending / Racks,0,0,0,0,0,0,0
LAB North,Jamaica,2025,Juices,Tropicana,STB - Push,Other Trade,Frozen Funds,0,0,0,0,0,0,0
LAB North,Jamaica,2025,Juices,Tropicana,STB - Push,Other Trade,Other Trade,0,0,0,0,0,0,0
LAB North,Jamaica,2025,Juices,Tropicana,STB - Push,Trade Equipment,Coolers - New,0,0,0,0,0,0,0
LAB North,Jamaica,2025,Juices,Tropicana,STB - Push,Trade Equipment,Coolers - Refurbished,0,0,0,0,0,0,0
LAB North,Jamaica,2025,Juices,Tropicana,STB - Push,Trade Equipment,Post Mix / Pre Mix Equip.,0,0,0,0,0,0,0
LAB North,Jamaica,2025,Juices,Tropicana,STB - Push,Trade Equipment,Vending / Racks,0,0,0,0,0,0,0
LAB North,Jamaica,2025,Juices,Tropicana,STB - Push,Trade Programs,Distribution Incentives,0,0,0,0,0,0,0
LAB North,Jamaica,2025,Juices,Tropicana,STB - Push,Trade Programs,Innovation Investments,0,0,0,0,0,0,0
LAB North,Jamaica,2025,Juices,Tropicana,STB - Push,Trade Programs,Sales Incentives,0,0,0,0,0,0,0
LAB North,Jamaica,2025,Juices,Tropicana,STB - Push,Trade Programs,Space Investments,50,33692,16846,16846,214,107,107
LAB North,Jamaica,2025,Juices,Tropicana,Pull-Working,All Other Working,Other Working - PR execution,0,0,0,0,0,0,0
LAB North,Jamaica,2025,Juices,Tropicana,Pull-Working,All Other Working,Other Working - activation,0,0,0,0,0,0,0
LAB North,Jamaica,2025,Juices,Tropicana,Pull-Working,All Other Working,Other Working - non allocated working,0,0,0,0,0,0,0
LAB North,Jamaica,2025,Juices,Tropicana,Pull-Working,Consumer Promotions,Consumer Promotions Execution,0,0,0,0,0,0,0
LAB North,Jamaica,2025,Juices,Tropicana,Pull-Working,Consumer Promotions,Coupons,0,0,0,0,0,0,0
LAB North,Jamaica,2025,Juices,Tropicana,Pull-Working,Consumer Promotions,Other,0,0,0,0,0,0,0
LAB North,Jamaica,2025,Juices,Tropicana,Pull-Working,Consumer Promotions,Premiums,50,14840,7420,7420,94,47,47
LAB North,Jamaica,2025,Juices,Tropicana,Pull-Working,In Store & POS Execution,In-Store & POS Execution,50,24104,12052,12052,153,76,77
LAB North,Jamaica,2025,Juices,Tropicana,Pull-Working,Media Placements,Cinema,0,0,0,0,0,0,0
LAB North,Jamaica,2025,Juices,Tropicana,Pull-Working,Media Placements,Digital,50,24380,12190,12190,155,77,78
LAB North,Jamaica,2025,Juices,Tropicana,Pull-Working,Media Placements,OOH - Out Of Home,0,0,0,0,0,0,0
LAB North,Jamaica,2025,Juices,Tropicana,Pull-Working,Media Placements,Other,0,0,0,0,0,0,0
LAB North,Jamaica,2025,Juices,Tropicana,Pull-Working,Media Placements,Print,0,0,0,0,0,0,0
LAB North,Jamaica,2025,Juices,Tropicana,Pull-Working,Media Placements,Radio,50,9009,4504,4505,57,28,29
LAB North,Jamaica,2025,Juices,Tropicana,Pull-Working,Media Placements,TV,0,0,0,0,0,0,0
LAB North,Jamaica,2025,Juices,Tropicana,Pull-Working,Sampling,Product Samples,0,0,0,0,0,0,0
LAB North,Jamaica,2025,Juices,Tropicana,Pull-Working,Sampling,Sampling Execution,0,0,0,0,0,0,0
LAB North,Jamaica,2025,Juices,Tropicana,Pull-Working,Sponsorships,Sponsorships-in game/ in show,50,4770,2385,2385,30,15,15
LAB North,Jamaica,2025,Juices,Tropicana,Pull-Working,Sponsorships,Sports-athlete/team contracts,0,0,0,0,0,0,0
LAB North,Jamaica,2025,Juices,Tropicana,Pull-Working,Sponsorships,Sports-on field or in show props,0,0,0,0,0,0,0
LAB North,Jamaica,2025,Juices,Tropicana,Pull-Working,Sponsorships,Sports-stadium contracts,0,0,0,0,0,0,0
LAB Mexico,Mexico,2025,Water,Be-Light,Pull-Non-Working,Ad Production,Digital Ad Production,0,0,0,0,0,0,0
LAB Mexico,Mexico,2025,Water,Be-Light,Pull-Non-Working,Ad Production,Other Ad Production,0,0,0,0,0,0,0
LAB Mexico,Mexico,2025,Water,Be-Light,Pull-Non-Working,Ad Production,TV Print Radio OOH Prod,100,491755,491755,0,26524,26524,0
LAB Mexico,Mexico,2025,Water,Be-Light,Pull-Non-Working,Agency Fees,Creative Agency Fees,0,0,0,0,0,0,0
LAB Mexico,Mexico,2025,Water,Be-Light,Pull-Non-Working,Agency Fees,In Store and POS Design/Development,0,0,0,0,0,0,0
LAB Mexico,Mexico,2025,Water,Be-Light,Pull-Non-Working,Agency Fees,Media Agency Fees,100,8605718,8605718,0,464181,464181,0
LAB Mexico,Mexico,2025,Water,Be-Light,Pull-Non-Working,Agency Fees,Other Agency Fees,0,0,0,0,0,0,0
LAB Mexico,Mexico,2025,Water,Be-Light,Pull-Non-Working,Agency Fees,Social Media/Influence Marketing,0,0,0,0,0,0,0
LAB Mexico,Mexico,2025,Water,Be-Light,Pull-Non-Working,Innovation and Insight,Innovation,0,0,0,0,0,0,0
LAB Mexico,Mexico,2025,Water,Be-Light,Pull-Non-Working,Innovation and Insight,Market Research,0,0,0,0,0,0,0
LAB Mexico,Mexico,2025,Water,Be-Light,Pull-Non-Working,Innovation and Insight,Other Innovation and Insight,0,0,0,0,0,0,0
LAB Mexico,Mexico,2025,Water,Be-Light,Pull-Non-Working,Insight,Advanced Analytics,100,983510,983510,0,53049,53049,0
LAB Mexico,Mexico,2025,Water,Be-Light,Pull-Non-Working,Insight,Brand Building,0,0,0,0,0,0,0
LAB Mexico,Mexico,2025,Water,Be-Light,Pull-Non-Working,Insight,Consumer Tracking,100,7130452,7130452,0,384607,384607,0
LAB Mexico,Mexico,2025,Water,Be-Light,Pull-Non-Working,Insight,Customer / Retail and Insights and Analytics,100,737632,737632,0,39786,39786,0
LAB Mexico,Mexico,2025,Water,Be-Light,Pull-Non-Working,Insight,Foundational Data / Systems,0,0,0,0,0,0,0
LAB Mexico,Mexico,2025,Water,Be-Light,Pull-Non-Working,Insight,Innovation Insights,0,0,0,0,0,0,0
LAB Mexico,Mexico,2025,Water,Be-Light,Pull-Non-Working,Insight,Strategic Insights,100,4917553,4917553,0,265246,265246,0
LAB Mexico,Mexico,2025,Water,Be-Light,Pull-Non-Working,Other Non Working,All Other Non Working,100,6146941,6146941,0,331558,331558,0
LAB Mexico,Mexico,2025,Water,Be-Light,Pull-Non-Working,Other Non Working,NW-Cross Charges,0,0,0,0,0,0,0
LAB Mexico,Mexico,2025,Water,Be-Light,Pull-Non-Working,Other Non Working,NW-Excluded non-A&M Items,0,0,0,0,0,0,0
LAB Mexico,Mexico,2025,Water,Be-Light,Pull-Non-Working,Other Non Working,NW-Fall In / Fall Out,0,0,0,0,0,0,0
LAB Mexico,Mexico,2025,Water,Be-Light,Pull-Non-Working,Other Non Working,Out of Scope Countries ( D8 Gastos),0,0,0,0,0,0,0
LAB Mexico,Mexico,2025,Water,Be-Light,Pull-Non-Working,Package Design,Other Package Design,0,0,0,0,0,0,0
LAB Mexico,Mexico,2025,Water,Be-Light,Pull-Non-Working,Package Design,Package Design,0,0,0,0,0,0,0
LAB Mexico,Mexico,2025,Water,Be-Light,Pull-Working,Consumer Promotions,Consumer Promotions Execution,0,76467952,0,76467952,4124583,0,4124583
LAB Mexico,Mexico,2025,Water,Be-Light,Pull-Working,Consumer Promotions,Coupons (Redemption),0,0,0,0,0,0,0
LAB Mexico,Mexico,2025,Water,Be-Light,Pull-Working,Consumer Promotions,Other Consumer Promotions,0,0,0,0,0,0,0
LAB Mexico,Mexico,2025,Water,Be-Light,Pull-Working,Consumer Promotions,Premiums,0,0,0,0,0,0,0
LAB Mexico,Mexico,2025,Water,Be-Light,Pull-Working,In Store & POS Execution,In-Store and POS Execution,100,3688164,3688164,0,198934,198934,0
LAB Mexico,Mexico,2025,Water,Be-Light,Pull-Working,In Store & POS Execution,Other In-Store and POS Execution,0,0,0,0,0,0,0
LAB Mexico,Mexico,2025,Water,Be-Light,Pull-Working,Media Placements,Digital Media,0,0,0,0,0,0,0
LAB Mexico,Mexico,2025,Water,Be-Light,Pull-Working,Media Placements,Media Placements,100,28767686,28767686,0,1551692,1551692,0
LAB Mexico,Mexico,2025,Water,Be-Light,Pull-Working,Media Placements,Other Media,0,0,0,0,0,0,0
LAB Mexico,Mexico,2025,Water,Be-Light,Pull-Working,Other Working,All Other Working,100,1229388,1229388,0,66311,66311,0
LAB Mexico,Mexico,2025,Water,Be-Light,Pull-Working,Other Working,W-Cross Charges,0,0,0,0,0,0,0
LAB Mexico,Mexico,2025,Water,Be-Light,Pull-Working,Other Working,W-Excluded non-A&M Items,0,0,0,0,0,0,0
LAB Mexico,Mexico,2025,Water,Be-Light,Pull-Working,Other Working,W-Fall In / Fall Out,0,0,0,0,0,0,0
LAB Mexico,Mexico,2025,Water,Be-Light,Pull-Working,Sampling,Other Sampling,0,0,0,0,0,0,0
LAB Mexico,Mexico,2025,Water,Be-Light,Pull-Working,Sampling,Product Samples,0,0,0,0,0,0,0
LAB Mexico,Mexico,2025,Water,Be-Light,Pull-Working,Sampling,Sample Executing,100,1721143,1721143,0,92836,92836,0
LAB Mexico,Mexico,2025,Water,Be-Light,Pull-Working,Sponsorships,Other Sponsorships,0,0,0,0,0,0,0
LAB Mexico,Mexico,2025,Water,Be-Light,Pull-Working,Sponsorships,Sponsorships,0,0,0,0,0,0,0
LAB Mexico,Mexico,2025,Water,Be-Light,STB - Push,Capability Building/Other,Capability Building,0,0,0,0,0,0,0
LAB Mexico,Mexico,2025,Water,Be-Light,STB - Push,Capability Building/Other,Capability Building/Other-Other,0,0,0,0,0,0,0
LAB Mexico,Mexico,2025,Water,Be-Light,STB - Push,Trade Equipment,On Premise Equipment,0,0,0,0,0,0,0
LAB Mexico,Mexico,2025,Water,Be-Light,STB - Push,Trade Equipment,"Stands/ Racks, Other Trade Equipment",0,245877,0,245877,13262,0,13262
LAB Mexico,Mexico,2025,Water,Be-Light,STB - Push,Trade Equipment,Trade Equipment-Other,0,0,0,0,0,0,0
LAB Mexico,Mexico,2025,Water,Be-Light,STB - Push,Trade Programs,Distribution Incentives,0,6638696,0,6638696,358082,0,358082
LAB Mexico,Mexico,2025,Water,Be-Light,STB - Push,Trade Programs,Innovation Investments,0,0,0,0,0,0,0
LAB Mexico,Mexico,2025,Water,Be-Light,STB - Push,Trade Programs,Other Trade Programs,0,0,0,0,0,0,0
LAB Mexico,Mexico,2025,Water,Be-Light,STB - Push,Trade Programs,Sales Incentives,0,0,0,0,0,0,0
LAB Mexico,Mexico,2025,Water,Be-Light,STB - Push,Trade Programs,Space Investments,0,18932579,0,18932579,1021199,0,1021199
LAB Mexico,Mexico,2025,Water,Be-Light,STB - Push,Unilateral,CDAs,0,79172606,0,79172606,4270468,0,4270468
LAB Mexico,Mexico,2025,Water,Be-Light,STB - Push,Unilateral,Capital Equipment,0,0,0,0,0,0,0
LAB Mexico,Mexico,2025,Water,Be-Light,STB - Push,Unilateral,Other Unilateral,0,0,0,0,0,0,0
LAB Mexico,Mexico,2025,Water,Be-Light,STB - Push,Unilateral,Price Support,0,0,0,0,0,0,0
LAB Mexico,Mexico,2025,Sport Drinks,Gatorade,Pull-Non-Working,Ad Production,Digital Ad Production,0,0,0,0,0,0,0
LAB Mexico,Mexico,2025,Sport Drinks,Gatorade,Pull-Non-Working,Ad Production,Other Ad Production,0,0,0,0,0,0,0
LAB Mexico,Mexico,2025,Sport Drinks,Gatorade,Pull-Non-Working,Ad Production,TV Print Radio OOH Prod,100,8555784,8555784,0,461488,461488,0
LAB Mexico,Mexico,2025,Sport Drinks,Gatorade,Pull-Non-Working,Agency Fees,Creative Agency Fees,0,0,0,0,0,0,0
LAB Mexico,Mexico,2025,Sport Drinks,Gatorade,Pull-Non-Working,Agency Fees,In Store and POS Design/Development,0,0,0,0,0,0,0
LAB Mexico,Mexico,2025,Sport Drinks,Gatorade,Pull-Non-Working,Agency Fees,Media Agency Fees,100,8555784,8555784,0,461488,461488,0
LAB Mexico,Mexico,2025,Sport Drinks,Gatorade,Pull-Non-Working,Agency Fees,Other Agency Fees,0,0,0,0,0,0,0
LAB Mexico,Mexico,2025,Sport Drinks,Gatorade,Pull-Non-Working,Agency Fees,Social Media/Influence Marketing,0,0,0,0,0,0,0
LAB Mexico,Mexico,2025,Sport Drinks,Gatorade,Pull-Non-Working,Innovation and Insight,Innovation,0,0,0,0,0,0,0
LAB Mexico,Mexico,2025,Sport Drinks,Gatorade,Pull-Non-Working,Innovation and Insight,Market Research,0,0,0,0,0,0,0
LAB Mexico,Mexico,2025,Sport Drinks,Gatorade,Pull-Non-Working,Innovation and Insight,Other Innovation and Insight,0,0,0,0,0,0,0
LAB Mexico,Mexico,2025,Sport Drinks,Gatorade,Pull-Non-Working,Insight,Advanced Analytics,100,4753213,4753213,0,256382,256382,0
LAB Mexico,Mexico,2025,Sport Drinks,Gatorade,Pull-Non-Working,Insight,Brand Building,0,0,0,0,0,0,0
LAB Mexico,Mexico,2025,Sport Drinks,Gatorade,Pull-Non-Working,Insight,Consumer Tracking,100,7605141,7605141,0,410211,410211,0
LAB Mexico,Mexico,2025,Sport Drinks,Gatorade,Pull-Non-Working,Insight,Customer / Retail and Insights and Analytics,100,950642,950642,0,51276,51276,0
LAB Mexico,Mexico,2025,Sport Drinks,Gatorade,Pull-Non-Working,Insight,Foundational Data / Systems,0,0,0,0,0,0,0
LAB Mexico,Mexico,2025,Sport Drinks,Gatorade,Pull-Non-Working,Insight,Innovation Insights,0,0,0,0,0,0,0
LAB Mexico,Mexico,2025,Sport Drinks,Gatorade,Pull-Non-Working,Insight,Strategic Insights,100,6654499,6654499,0,358935,358935,0
LAB Mexico,Mexico,2025,Sport Drinks,Gatorade,Pull-Non-Working,Other Non Working,All Other Non Working,100,19012854,19012854,0,1025528,1025528,0
LAB Mexico,Mexico,2025,Sport Drinks,Gatorade,Pull-Non-Working,Other Non Working,NW-Cross Charges,0,0,0,0,0,0,0
LAB Mexico,Mexico,2025,Sport Drinks,Gatorade,Pull-Non-Working,Other Non Working,NW-Excluded non-A&M Items,0,0,0,0,0,0,0
LAB Mexico,Mexico,2025,Sport Drinks,Gatorade,Pull-Non-Working,Other Non Working,NW-Fall In / Fall Out,0,0,0,0,0,0,0
LAB Mexico,Mexico,2025,Sport Drinks,Gatorade,Pull-Non-Working,Other Non Working,Out of Scope Countries ( D8 Gastos),0,0,0,0,0,0,0
LAB Mexico,Mexico,2025,Sport Drinks,Gatorade,Pull-Non-Working,Package Design,Other Package Design,0,0,0,0,0,0,0
LAB Mexico,Mexico,2025,Sport Drinks,Gatorade,Pull-Non-Working,Package Design,Package Design,0,0,0,0,0,0,0
LAB Mexico,Mexico,2025,Sport Drinks,Gatorade,Pull-Working,Consumer Promotions,Consumer Promotions Execution,0,190128543,0,190128543,10255289,0,10255289
LAB Mexico,Mexico,2025,Sport Drinks,Gatorade,Pull-Working,Consumer Promotions,Coupons (Redemption),0,0,0,0,0,0,0
LAB Mexico,Mexico,2025,Sport Drinks,Gatorade,Pull-Working,Consumer Promotions,Other Consumer Promotions,0,0,0,0,0,0,0
LAB Mexico,Mexico,2025,Sport Drinks,Gatorade,Pull-Working,Consumer Promotions,Premiums,100,10457069,10457069,0,564040,564040,0
LAB Mexico,Mexico,2025,Sport Drinks,Gatorade,Pull-Working,In Store & POS Execution,In-Store and POS Execution,100,16160926,16160926,0,871699,871699,0
LAB Mexico,Mexico,2025,Sport Drinks,Gatorade,Pull-Working,In Store & POS Execution,Other In-Store and POS Execution,0,0,0,0,0,0,0
LAB Mexico,Mexico,2025,Sport Drinks,Gatorade,Pull-Working,Media Placements,Digital Media,0,0,0,0,0,0,0
LAB Mexico,Mexico,2025,Sport Drinks,Gatorade,Pull-Working,Media Placements,Media Placements,100,74150131,74150131,0,3999563,3999563,0
LAB Mexico,Mexico,2025,Sport Drinks,Gatorade,Pull-Working,Media Placements,Other Media,0,0,0,0,0,0,0
LAB Mexico,Mexico,2025,Sport Drinks,Gatorade,Pull-Working,Other Working,All Other Working,100,23766067,23766067,0,1281911,1281911,0
LAB Mexico,Mexico,2025,Sport Drinks,Gatorade,Pull-Working,Other Working,W-Cross Charges,0,0,0,0,0,0,0
LAB Mexico,Mexico,2025,Sport Drinks,Gatorade,Pull-Working,Other Working,W-Excluded non-A&M Items,0,0,0,0,0,0,0
LAB Mexico,Mexico,2025,Sport Drinks,Gatorade,Pull-Working,Other Working,W-Fall In / Fall Out,0,0,0,0,0,0,0
LAB Mexico,Mexico,2025,Sport Drinks,Gatorade,Pull-Working,Sampling,Other Sampling,0,0,0,0,0,0,0
LAB Mexico,Mexico,2025,Sport Drinks,Gatorade,Pull-Working,Sampling,Product Samples,0,0,0,0,0,0,0
LAB Mexico,Mexico,2025,Sport Drinks,Gatorade,Pull-Working,Sampling,Sample Executing,100,1901285,1901285,0,102552,102552,0
LAB Mexico,Mexico,2025,Sport Drinks,Gatorade,Pull-Working,Sponsorships,Other Sponsorships,0,0,0,0,0,0,0
LAB Mexico,Mexico,2025,Sport Drinks,Gatorade,Pull-Working,Sponsorships,Sponsorships,100,90311057,90311057,0,4871262,4871262,0
LAB Mexico,Mexico,2025,Sport Drinks,Gatorade,STB - Push,Capability Building/Other,Capability Building,0,1901285,0,1901285,102552,0,102552
LAB Mexico,Mexico,2025,Sport Drinks,Gatorade,STB - Push,Capability Building/Other,Capability Building/Other-Other,0,0,0,0,0,0,0
LAB Mexico,Mexico,2025,Sport Drinks,Gatorade,STB - Push,Trade Equipment,On Premise Equipment,0,950642,0,950642,51276,0,51276
LAB Mexico,Mexico,2025,Sport Drinks,Gatorade,STB - Push,Trade Equipment,"Stands/ Racks, Other Trade Equipment",0,1901285,0,1901285,102552,0,102552
LAB Mexico,Mexico,2025,Sport Drinks,Gatorade,STB - Push,Trade Equipment,Trade Equipment-Other,0,0,0,0,0,0,0
LAB Mexico,Mexico,2025,Sport Drinks,Gatorade,STB - Push,Trade Programs,Distribution Incentives,0,88409772,0,88409772,4768709,0,4768709
LAB Mexico,Mexico,2025,Sport Drinks,Gatorade,STB - Push,Trade Programs,Innovation Investments,0,0,0,0,0,0,0
LAB Mexico,Mexico,2025,Sport Drinks,Gatorade,STB - Push,Trade Programs,Other Trade Programs,0,0,0,0,0,0,0
LAB Mexico,Mexico,2025,Sport Drinks,Gatorade,STB - Push,Trade Programs,Sales Incentives,0,0,0,0,0,0,0
LAB Mexico,Mexico,2025,Sport Drinks,Gatorade,STB - Push,Trade Programs,Space Investments,0,91261700,0,91261700,4922539,0,4922539
LAB Mexico,Mexico,2025,Sport Drinks,Gatorade,STB - Push,Unilateral,CDAs,0,303255026,0,303255026,16357187,0,16357187
LAB Mexico,Mexico,2025,Sport Drinks,Gatorade,STB - Push,Unilateral,Capital Equipment,0,0,0,0,0,0,0
LAB Mexico,Mexico,2025,Sport Drinks,Gatorade,STB - Push,Unilateral,Other Unilateral,0,0,0,0,0,0,0
LAB Mexico,Mexico,2025,Sport Drinks,Gatorade,STB - Push,Unilateral,Price Support,0,0,0,0,0,0,0
LAB Mexico,Mexico,2025,RTD Tea,Lipton,Pull-Non-Working,Ad Production,Digital Ad Production,0,0,0,0,0,0,0
LAB Mexico,Mexico,2025,RTD Tea,Lipton,Pull-Non-Working,Ad Production,Other Ad Production,0,0,0,0,0,0,0
LAB Mexico,Mexico,2025,RTD Tea,Lipton,Pull-Non-Working,Ad Production,TV Print Radio OOH Prod,100,662568,662568,0,35738,35738,0
LAB Mexico,Mexico,2025,RTD Tea,Lipton,Pull-Non-Working,Agency Fees,Creative Agency Fees,0,0,0,0,0,0,0
LAB Mexico,Mexico,2025,RTD Tea,Lipton,Pull-Non-Working,Agency Fees,In Store and POS Design/Development,0,0,0,0,0,0,0
LAB Mexico,Mexico,2025,RTD Tea,Lipton,Pull-Non-Working,Agency Fees,Media Agency Fees,100,1030662,1030662,0,55592,55592,0
LAB Mexico,Mexico,2025,RTD Tea,Lipton,Pull-Non-Working,Agency Fees,Other Agency Fees,0,0,0,0,0,0,0
LAB Mexico,Mexico,2025,RTD Tea,Lipton,Pull-Non-Working,Agency Fees,Social Media/Influence Marketing,0,0,0,0,0,0,0
LAB Mexico,Mexico,2025,RTD Tea,Lipton,Pull-Non-Working,Innovation and Insight,Innovation,0,0,0,0,0,0,0
LAB Mexico,Mexico,2025,RTD Tea,Lipton,Pull-Non-Working,Innovation and Insight,Market Research,0,0,0,0,0,0,0
LAB Mexico,Mexico,2025,RTD Tea,Lipton,Pull-Non-Working,Innovation and Insight,Other Innovation and Insight,0,0,0,0,0,0,0
LAB Mexico,Mexico,2025,RTD Tea,Lipton,Pull-Non-Working,Insight,Advanced Analytics,100,1104280,1104280,0,59563,59563,0
LAB Mexico,Mexico,2025,RTD Tea,Lipton,Pull-Non-Working,Insight,Brand Building,0,0,0,0,0,0,0
LAB Mexico,Mexico,2025,RTD Tea,Lipton,Pull-Non-Working,Insight,Consumer Tracking,100,1545993,1545993,0,83388,83388,0
LAB Mexico,Mexico,2025,RTD Tea,Lipton,Pull-Non-Working,Insight,Customer / Retail and Insights and Analytics,0,0,0,0,0,0,0
LAB Mexico,Mexico,2025,RTD Tea,Lipton,Pull-Non-Working,Insight,Foundational Data / Systems,0,0,0,0,0,0,0
LAB Mexico,Mexico,2025,RTD Tea,Lipton,Pull-Non-Working,Insight,Innovation Insights,0,0,0,0,0,0,0
LAB Mexico,Mexico,2025,RTD Tea,Lipton,Pull-Non-Working,Insight,Strategic Insights,100,294474,294474,0,15883,15883,0
LAB Mexico,Mexico,2025,RTD Tea,Lipton,Pull-Non-Working,Other Non Working,All Other Non Working,100,2282180,2282180,0,123097,123097,0
LAB Mexico,Mexico,2025,RTD Tea,Lipton,Pull-Non-Working,Other Non Working,NW-Cross Charges,0,0,0,0,0,0,0
LAB Mexico,Mexico,2025,RTD Tea,Lipton,Pull-Non-Working,Other Non Working,NW-Excluded non-A&M Items,0,0,0,0,0,0,0
LAB Mexico,Mexico,2025,RTD Tea,Lipton,Pull-Non-Working,Other Non Working,NW-Fall In / Fall Out,0,0,0,0,0,0,0
LAB Mexico,Mexico,2025,RTD Tea,Lipton,Pull-Non-Working,Other Non Working,Out of Scope Countries ( D8 Gastos),0,0,0,0,0,0,0
LAB Mexico,Mexico,2025,RTD Tea,Lipton,Pull-Non-Working,Package Design,Other Package Design,0,0,0,0,0,0,0
LAB Mexico,Mexico,2025,RTD Tea,Lipton,Pull-Non-Working,Package Design,Package Design,0,0,0,0,0,0,0
LAB Mexico,Mexico,2025,RTD Tea,Lipton,Pull-Working,Consumer Promotions,Consumer Promotions Execution,0,6920159,0,6920159,373264,0,373264
LAB Mexico,Mexico,2025,RTD Tea,Lipton,Pull-Working,Consumer Promotions,Coupons (Redemption),0,0,0,0,0,0,0
LAB Mexico,Mexico,2025,RTD Tea,Lipton,Pull-Working,Consumer Promotions,Other Consumer Promotions,0,0,0,0,0,0,0
LAB Mexico,Mexico,2025,RTD Tea,Lipton,Pull-Working,Consumer Promotions,Premiums,0,0,0,0,0,0,0
LAB Mexico,Mexico,2025,RTD Tea,Lipton,Pull-Working,In Store & POS Execution,In-Store and POS Execution,0,0,0,0,0,0,0
LAB Mexico,Mexico,2025,RTD Tea,Lipton,Pull-Working,In Store & POS Execution,Other In-Store and POS Execution,0,0,0,0,0,0,0
LAB Mexico,Mexico,2025,RTD Tea,Lipton,Pull-Working,Media Placements,Digital Media,0,0,0,0,0,0,0
LAB Mexico,Mexico,2025,RTD Tea,Lipton,Pull-Working,Media Placements,Media Placements,100,4564360,4564360,0,246195,246195,0
LAB Mexico,Mexico,2025,RTD Tea,Lipton,Pull-Working,Media Placements,Other Media,0,0,0,0,0,0,0
LAB Mexico,Mexico,2025,RTD Tea,Lipton,Pull-Working,Other Working,All Other Working,100,515331,515331,0,27796,27796,0
LAB Mexico,Mexico,2025,RTD Tea,Lipton,Pull-Working,Other Working,W-Cross Charges,0,0,0,0,0,0,0
LAB Mexico,Mexico,2025,RTD Tea,Lipton,Pull-Working,Other Working,W-Excluded non-A&M Items,0,0,0,0,0,0,0
LAB Mexico,Mexico,2025,RTD Tea,Lipton,Pull-Working,Other Working,W-Fall In / Fall Out,0,0,0,0,0,0,0
LAB Mexico,Mexico,2025,RTD Tea,Lipton,Pull-Working,Sampling,Other Sampling,0,0,0,0,0,0,0
LAB Mexico,Mexico,2025,RTD Tea,Lipton,Pull-Working,Sampling,Product Samples,0,0,0,0,0,0,0
LAB Mexico,Mexico,2025,RTD Tea,Lipton,Pull-Working,Sampling,Sample Executing,100,220856,220856,0,11912,11912,0
LAB Mexico,Mexico,2025,RTD Tea,Lipton,Pull-Working,Sponsorships,Other Sponsorships,0,0,0,0,0,0,0
LAB Mexico,Mexico,2025,RTD Tea,Lipton,Pull-Working,Sponsorships,Sponsorships,0,0,0,0,0,0,0
LAB Mexico,Mexico,2025,RTD Tea,Lipton,STB - Push,Capability Building/Other,Capability Building,0,0,0,0,0,0,0
LAB Mexico,Mexico,2025,RTD Tea,Lipton,STB - Push,Capability Building/Other,Capability Building/Other-Other,0,0,0,0,0,0,0
LAB Mexico,Mexico,2025,RTD Tea,Lipton,STB - Push,Trade Equipment,On Premise Equipment,0,73618,0,73618,3970,0,3970
LAB Mexico,Mexico,2025,RTD Tea,Lipton,STB - Push,Trade Equipment,"Stands/ Racks, Other Trade Equipment",0,73618,0,73618,3970,0,3970
LAB Mexico,Mexico,2025,RTD Tea,Lipton,STB - Push,Trade Equipment,Trade Equipment-Other,0,0,0,0,0,0,0
LAB Mexico,Mexico,2025,RTD Tea,Lipton,STB - Push,Trade Programs,Distribution Incentives,0,3901791,0,3901791,210457,0,210457
LAB Mexico,Mexico,2025,RTD Tea,Lipton,STB - Push,Trade Programs,Innovation Investments,0,0,0,0,0,0,0
LAB Mexico,Mexico,2025,RTD Tea,Lipton,STB - Push,Trade Programs,Other Trade Programs,0,0,0,0,0,0,0
LAB Mexico,Mexico,2025,RTD Tea,Lipton,STB - Push,Trade Programs,Sales Incentives,0,0,0,0,0,0,0
LAB Mexico,Mexico,2025,RTD Tea,Lipton,STB - Push,Trade Programs,Space Investments,0,13030512,0,13030512,702849,0,702849
LAB Mexico,Mexico,2025,RTD Tea,Lipton,STB - Push,Unilateral,CDAs,0,37398308,0,37398308,2017216,0,2017216
LAB Mexico,Mexico,2025,RTD Tea,Lipton,STB - Push,Unilateral,Capital Equipment,0,0,0,0,0,0,0
LAB Mexico,Mexico,2025,RTD Tea,Lipton,STB - Push,Unilateral,Other Unilateral,0,0,0,0,0,0,0
LAB Mexico,Mexico,2025,RTD Tea,Lipton,STB - Push,Unilateral,Price Support,0,0,0,0,0,0,0
LAB Mexico,Mexico,2025,CSD,Pepsi,Pull-Non-Working,Ad Production,Digital Ad Production,0,0,0,0,0,0,0
LAB Mexico,Mexico,2025,CSD,Pepsi,Pull-Non-Working,Ad Production,Other Ad Production,0,0,0,0,0,0,0
LAB Mexico,Mexico,2025,CSD,Pepsi,Pull-Non-Working,Ad Production,TV Print Radio OOH Prod,100,16779686,16779686,0,905074,905074,0
LAB Mexico,Mexico,2025,CSD,Pepsi,Pull-Non-Working,Agency Fees,Creative Agency Fees,0,0,0,0,0,0,0
LAB Mexico,Mexico,2025,CSD,Pepsi,Pull-Non-Working,Agency Fees,In Store and POS Design/Development,0,0,0,0,0,0,0
LAB Mexico,Mexico,2025,CSD,Pepsi,Pull-Non-Working,Agency Fees,Media Agency Fees,100,36991581,36991581,0,1995278,1995278,0
LAB Mexico,Mexico,2025,CSD,Pepsi,Pull-Non-Working,Agency Fees,Other Agency Fees,0,0,0,0,0,0,0
LAB Mexico,Mexico,2025,CSD,Pepsi,Pull-Non-Working,Agency Fees,Social Media/Influence Marketing,0,0,0,0,0,0,0
LAB Mexico,Mexico,2025,CSD,Pepsi,Pull-Non-Working,Innovation and Insight,Innovation,0,0,0,0,0,0,0
LAB Mexico,Mexico,2025,CSD,Pepsi,Pull-Non-Working,Innovation and Insight,Market Research,0,0,0,0,0,0,0
LAB Mexico,Mexico,2025,CSD,Pepsi,Pull-Non-Working,Innovation and Insight,Other Innovation and Insight,0,0,0,0,0,0,0
LAB Mexico,Mexico,2025,CSD,Pepsi,Pull-Non-Working,Insight,Advanced Analytics,100,59491614,59491614,0,3208901,3208901,0
LAB Mexico,Mexico,2025,CSD,Pepsi,Pull-Non-Working,Insight,Brand Building,0,0,0,0,0,0,0
LAB Mexico,Mexico,2025,CSD,Pepsi,Pull-Non-Working,Insight,Consumer Tracking,100,29364450,29364450,0,1583880,1583880,0
LAB Mexico,Mexico,2025,CSD,Pepsi,Pull-Non-Working,Insight,Customer / Retail and Insights and Analytics,100,762713,762713,0,41139,41139,0
LAB Mexico,Mexico,2025,CSD,Pepsi,Pull-Non-Working,Insight,Foundational Data / Systems,0,0,0,0,0,0,0
LAB Mexico,Mexico,2025,CSD,Pepsi,Pull-Non-Working,Insight,Innovation Insights,0,0,0,0,0,0,0
LAB Mexico,Mexico,2025,CSD,Pepsi,Pull-Non-Working,Insight,Strategic Insights,100,18686468,18686468,0,1007924,1007924,0
LAB Mexico,Mexico,2025,CSD,Pepsi,Pull-Non-Working,Other Non Working,All Other Non Working,100,94576413,94576413,0,5101330,5101330,0
LAB Mexico,Mexico,2025,CSD,Pepsi,Pull-Non-Working,Other Non Working,NW-Cross Charges,0,0,0,0,0,0,0
LAB Mexico,Mexico,2025,CSD,Pepsi,Pull-Non-Working,Other Non Working,NW-Excluded non-A&M Items,0,0,0,0,0,0,0
LAB Mexico,Mexico,2025,CSD,Pepsi,Pull-Non-Working,Other Non Working,NW-Fall In / Fall Out,0,0,0,0,0,0,0
LAB Mexico,Mexico,2025,CSD,Pepsi,Pull-Non-Working,Other Non Working,Out of Scope Countries ( D8 Gastos),0,0,0,0,0,0,0
LAB Mexico,Mexico,2025,CSD,Pepsi,Pull-Non-Working,Package Design,Other Package Design,0,0,0,0,0,0,0
LAB Mexico,Mexico,2025,CSD,Pepsi,Pull-Non-Working,Package Design,Package Design,0,0,0,0,0,0,0
LAB Mexico,Mexico,2025,CSD,Pepsi,Pull-Working,Consumer Promotions,Consumer Promotions Execution,0,1456781853,0,1456781853,78576946,0,78576946
LAB Mexico,Mexico,2025,CSD,Pepsi,Pull-Working,Consumer Promotions,Coupons (Redemption),0,0,0,0,0,0,0
LAB Mexico,Mexico,2025,CSD,Pepsi,Pull-Working,Consumer Promotions,Other Consumer Promotions,0,0,0,0,0,0,0
LAB Mexico,Mexico,2025,CSD,Pepsi,Pull-Working,Consumer Promotions,Premiums,100,62923823,62923823,0,3394030,3394030,0
LAB Mexico,Mexico,2025,CSD,Pepsi,Pull-Working,In Store & POS Execution,In-Store and POS Execution,100,116313734,116313734,0,6273813,6273813,0
LAB Mexico,Mexico,2025,CSD,Pepsi,Pull-Working,In Store & POS Execution,Other In-Store and POS Execution,0,0,0,0,0,0,0
LAB Mexico,Mexico,2025,CSD,Pepsi,Pull-Working,Media Placements,Digital Media,0,0,0,0,0,0,0
LAB Mexico,Mexico,2025,CSD,Pepsi,Pull-Working,Media Placements,Media Placements,100,311186908,311186908,0,16785023,16785023,0
LAB Mexico,Mexico,2025,CSD,Pepsi,Pull-Working,Media Placements,Other Media,100,1906782,1906782,0,102849,102849,0
LAB Mexico,Mexico,2025,CSD,Pepsi,Pull-Working,Other Working,All Other Working,100,27076311,27076311,0,1460461,1460461,0
LAB Mexico,Mexico,2025,CSD,Pepsi,Pull-Working,Other Working,W-Cross Charges,0,0,0,0,0,0,0
LAB Mexico,Mexico,2025,CSD,Pepsi,Pull-Working,Other Working,W-Excluded non-A&M Items,0,0,0,0,0,0,0
LAB Mexico,Mexico,2025,CSD,Pepsi,Pull-Working,Other Working,W-Fall In / Fall Out,0,0,0,0,0,0,0
LAB Mexico,Mexico,2025,CSD,Pepsi,Pull-Working,Sampling,Other Sampling,0,0,0,0,0,0,0
LAB Mexico,Mexico,2025,CSD,Pepsi,Pull-Working,Sampling,Product Samples,100,1143688,1143688,0,61689,61689,0
LAB Mexico,Mexico,2025,CSD,Pepsi,Pull-Working,Sampling,Sample Executing,100,16398329,16398329,0,884504,884504,0
LAB Mexico,Mexico,2025,CSD,Pepsi,Pull-Working,Sponsorships,Other Sponsorships,0,0,0,0,0,0,0
LAB Mexico,Mexico,2025,CSD,Pepsi,Pull-Working,Sponsorships,Sponsorships,100,138813768,138813768,0,7487436,7487436,0
LAB Mexico,Mexico,2025,CSD,Pepsi,STB - Push,Capability Building/Other,Capability Building,0,45381042,0,45381042,2447795,0,2447795
LAB Mexico,Mexico,2025,CSD,Pepsi,STB - Push,Capability Building/Other,Capability Building/Other-Other,0,0,0,0,0,0,0
LAB Mexico,Mexico,2025,CSD,Pepsi,STB - Push,Trade Equipment,On Premise Equipment,0,52245841,0,52245841,2818073,0,2818073
LAB Mexico,Mexico,2025,CSD,Pepsi,STB - Push,Trade Equipment,"Stands/ Racks, Other Trade Equipment",0,3813565,0,3813565,205698,0,205698
LAB Mexico,Mexico,2025,CSD,Pepsi,STB - Push,Trade Equipment,Trade Equipment-Other,0,0,0,0,0,0,0
LAB Mexico,Mexico,2025,CSD,Pepsi,STB - Push,Trade Programs,Distribution Incentives,0,360000541,0,360000541,19417967,0,19417967
LAB Mexico,Mexico,2025,CSD,Pepsi,STB - Push,Trade Programs,Innovation Investments,0,0,0,0,0,0,0
LAB Mexico,Mexico,2025,CSD,Pepsi,STB - Push,Trade Programs,Other Trade Programs,0,0,0,0,0,0,0
LAB Mexico,Mexico,2025,CSD,Pepsi,STB - Push,Trade Programs,Sales Incentives,0,0,0,0,0,0,0
LAB Mexico,Mexico,2025,CSD,Pepsi,STB - Push,Trade Programs,Space Investments,0,88856065,0,88856065,4792782,0,4792782
LAB Mexico,Mexico,2025,CSD,Pepsi,STB - Push,Unilateral,CDAs,0,874069111,0,874069111,47146167,0,47146167
LAB Mexico,Mexico,2025,CSD,Pepsi,STB - Push,Unilateral,Capital Equipment,0,762,0,762,41,0,41
LAB Mexico,Mexico,2025,CSD,Pepsi,STB - Push,Unilateral,Other Unilateral,0,0,0,0,0,0,0
LAB Mexico,Mexico,2025,CSD,Pepsi,STB - Push,Unilateral,Price Support,0,0,0,0,0,0,0
LAB Mexico,Mexico,2025,Others,Sabores,Pull-Non-Working,Ad Production,Digital Ad Production,100,42,42,0,2,2,0
LAB Mexico,Mexico,2025,Others,Sabores,Pull-Non-Working,Ad Production,Other Ad Production,0,0,0,0,0,0,0
LAB Mexico,Mexico,2025,Others,Sabores,Pull-Non-Working,Ad Production,TV Print Radio OOH Prod,100,2898988,2898988,0,156367,156367,0
LAB Mexico,Mexico,2025,Others,Sabores,Pull-Non-Working,Agency Fees,Creative Agency Fees,0,0,0,0,0,0,0
LAB Mexico,Mexico,2025,Others,Sabores,Pull-Non-Working,Agency Fees,In Store and POS Design/Development,0,0,0,0,0,0,0
LAB Mexico,Mexico,2025,Others,Sabores,Pull-Non-Working,Agency Fees,Media Agency Fees,100,6390952,6390952,0,344719,344719,0
LAB Mexico,Mexico,2025,Others,Sabores,Pull-Non-Working,Agency Fees,Other Agency Fees,0,0,0,0,0,0,0
LAB Mexico,Mexico,2025,Others,Sabores,Pull-Non-Working,Agency Fees,Social Media/Influence Marketing,0,0,0,0,0,0,0
LAB Mexico,Mexico,2025,Others,Sabores,Pull-Non-Working,Innovation and Insight,Innovation,0,0,0,0,0,0,0
LAB Mexico,Mexico,2025,Others,Sabores,Pull-Non-Working,Innovation and Insight,Market Research,0,0,0,0,0,0,0
LAB Mexico,Mexico,2025,Others,Sabores,Pull-Non-Working,Innovation and Insight,Other Innovation and Insight,0,0,0,0,0,0,0
LAB Mexico,Mexico,2025,Others,Sabores,Pull-Non-Working,Insight,Advanced Analytics,100,10278233,10278233,0,554394,554394,0
LAB Mexico,Mexico,2025,Others,Sabores,Pull-Non-Working,Insight,Brand Building,0,0,0,0,0,0,0
LAB Mexico,Mexico,2025,Others,Sabores,Pull-Non-Working,Insight,Consumer Tracking,100,5073230,5073230,0,273643,273643,0
LAB Mexico,Mexico,2025,Others,Sabores,Pull-Non-Working,Insight,Customer / Retail and Insights and Analytics,100,131772,131772,0,7107,7107,0
LAB Mexico,Mexico,2025,Others,Sabores,Pull-Non-Working,Insight,Foundational Data / Systems,0,0,0,0,0,0,0
LAB Mexico,Mexico,2025,Others,Sabores,Pull-Non-Working,Insight,Innovation Insights,0,0,0,0,0,0,0
LAB Mexico,Mexico,2025,Others,Sabores,Pull-Non-Working,Insight,Strategic Insights,100,3228419,3228419,0,174136,174136,0
LAB Mexico,Mexico,2025,Others,Sabores,Pull-Non-Working,Other Non Working,All Other Non Working,100,16339755,16339755,0,881345,881345,0
LAB Mexico,Mexico,2025,Others,Sabores,Pull-Non-Working,Other Non Working,NW-Cross Charges,0,0,0,0,0,0,0
LAB Mexico,Mexico,2025,Others,Sabores,Pull-Non-Working,Other Non Working,NW-Excluded non-A&M Items,0,0,0,0,0,0,0
LAB Mexico,Mexico,2025,Others,Sabores,Pull-Non-Working,Other Non Working,NW-Fall In / Fall Out,0,0,0,0,0,0,0
LAB Mexico,Mexico,2025,Others,Sabores,Pull-Non-Working,Other Non Working,Out of Scope Countries ( D8 Gastos),0,0,0,0,0,0,0
LAB Mexico,Mexico,2025,Others,Sabores,Pull-Non-Working,Package Design,Other Package Design,0,0,0,0,0,0,0
LAB Mexico,Mexico,2025,Others,Sabores,Pull-Non-Working,Package Design,Package Design,0,0,0,0,0,0,0
LAB Mexico,Mexico,2025,Others,Sabores,Pull-Working,Consumer Promotions,Consumer Promotions Execution,0,251684948,0,251684948,13575563,0,13575563
LAB Mexico,Mexico,2025,Others,Sabores,Pull-Working,Consumer Promotions,Coupons (Redemption),0,36,0,36,1,0,1
LAB Mexico,Mexico,2025,Others,Sabores,Pull-Working,Consumer Promotions,Other Consumer Promotions,0,0,0,0,0,0,0
LAB Mexico,Mexico,2025,Others,Sabores,Pull-Working,Consumer Promotions,Premiums,100,10871261,10871261,0,586381,586381,0
LAB Mexico,Mexico,2025,Others,Sabores,Pull-Working,In Store & POS Execution,In-Store and POS Execution,100,20095264,20095264,0,1083912,1083912,0
LAB Mexico,Mexico,2025,Others,Sabores,Pull-Working,In Store & POS Execution,Other In-Store and POS Execution,0,0,0,0,0,0,0
LAB Mexico,Mexico,2025,Others,Sabores,Pull-Working,Media Placements,Digital Media,0,0,0,0,0,0,0
LAB Mexico,Mexico,2025,Others,Sabores,Pull-Working,Media Placements,Media Placements,100,53763067,53763067,0,2899910,2899910,0
LAB Mexico,Mexico,2025,Others,Sabores,Pull-Working,Media Placements,Other Media,100,329430,329430,0,17769,17769,0
LAB Mexico,Mexico,2025,Others,Sabores,Pull-Working,Other Working,All Other Working,100,4696020,4696020,0,253297,253297,0
LAB Mexico,Mexico,2025,Others,Sabores,Pull-Working,Other Working,W-Cross Charges,0,0,0,0,0,0,0
LAB Mexico,Mexico,2025,Others,Sabores,Pull-Working,Other Working,W-Excluded non-A&M Items,0,0,0,0,0,0,0
LAB Mexico,Mexico,2025,Others,Sabores,Pull-Working,Other Working,W-Fall In / Fall Out,0,0,0,0,0,0,0
LAB Mexico,Mexico,2025,Others,Sabores,Pull-Working,Sampling,Other Sampling,0,0,0,0,0,0,0
LAB Mexico,Mexico,2025,Others,Sabores,Pull-Working,Sampling,Product Samples,100,197592,197592,0,10657,10657,0
LAB Mexico,Mexico,2025,Others,Sabores,Pull-Working,Sampling,Sample Executing,100,2833102,2833102,0,152813,152813,0
LAB Mexico,Mexico,2025,Others,Sabores,Pull-Working,Sponsorships,Other Sponsorships,0,0,0,0,0,0,0
LAB Mexico,Mexico,2025,Others,Sabores,Pull-Working,Sponsorships,Sponsorships,100,23982544,23982544,0,1293587,1293587,0
LAB Mexico,Mexico,2025,Others,Sabores,STB - Push,Capability Building/Other,Capability Building,0,7840381,0,7840381,422900,0,422900
LAB Mexico,Mexico,2025,Others,Sabores,STB - Push,Capability Building/Other,Capability Building/Other-Other,0,0,0,0,0,0,0
LAB Mexico,Mexico,2025,Others,Sabores,STB - Push,Trade Equipment,On Premise Equipment,0,9026397,0,9026397,486872,0,486872
LAB Mexico,Mexico,2025,Others,Sabores,STB - Push,Trade Equipment,"Stands/ Racks, Other Trade Equipment",0,658861,0,658861,35538,0,35538
LAB Mexico,Mexico,2025,Others,Sabores,STB - Push,Trade Equipment,Trade Equipment-Other,0,0,0,0,0,0,0
LAB Mexico,Mexico,2025,Others,Sabores,STB - Push,Trade Programs,Distribution Incentives,0,62196489,0,62196489,3354798,0,3354798
LAB Mexico,Mexico,2025,Others,Sabores,STB - Push,Trade Programs,Innovation Investments,0,0,0,0,0,0,0
LAB Mexico,Mexico,2025,Others,Sabores,STB - Push,Trade Programs,Other Trade Programs,0,0,0,0,0,0,0
LAB Mexico,Mexico,2025,Others,Sabores,STB - Push,Trade Programs,Sales Incentives,0,0,0,0,0,0,0
LAB Mexico,Mexico,2025,Others,Sabores,STB - Push,Trade Programs,Space Investments,0,15351464,0,15351464,828038,0,828038
LAB Mexico,Mexico,2025,Others,Sabores,STB - Push,Unilateral,CDAs,0,150992862,0,150992862,8144361,0,8144361
LAB Mexico,Mexico,2025,Others,Sabores,STB - Push,Unilateral,Capital Equipment,0,0,0,0,0,0,0
LAB Mexico,Mexico,2025,Others,Sabores,STB - Push,Unilateral,Other Unilateral,0,0,0,0,0,0,0
LAB Mexico,Mexico,2025,Others,Sabores,STB - Push,Unilateral,Price Support,0,0,0,0,0,0,0
LAB North,Nicaragua,2025,Energy Drinks,Adrenaline,Pull-Non-Working,Ad Production,Digital Ad Production,0,0,0,0,0,0,0
LAB North,Nicaragua,2025,Energy Drinks,Adrenaline,Pull-Non-Working,Ad Production,"TV, Print, Radio, OOH, Production",0,0,0,0,0,0,0
LAB North,Nicaragua,2025,Energy Drinks,Adrenaline,Pull-Non-Working,Agency Fees,Creative Agency Fees,0,0,0,0,0,0,0
LAB North,Nicaragua,2025,Energy Drinks,Adrenaline,Pull-Non-Working,Agency Fees,In Store & POS Design / Development,0,0,0,0,0,0,0
LAB North,Nicaragua,2025,Energy Drinks,Adrenaline,Pull-Non-Working,Agency Fees,Media Agency Fees,0,0,0,0,0,0,0
LAB North,Nicaragua,2025,Energy Drinks,Adrenaline,Pull-Non-Working,Agency Fees,Other,0,0,0,0,0,0,0
LAB North,Nicaragua,2025,Energy Drinks,Adrenaline,Pull-Non-Working,Agency Fees,Social Media / Influence Marketing,0,0,0,0,0,0,0
LAB North,Nicaragua,2025,Energy Drinks,Adrenaline,Pull-Non-Working,All Other Non-Working,Administrative fees,0,0,0,0,0,0,0
LAB North,Nicaragua,2025,Energy Drinks,Adrenaline,Pull-Non-Working,All Other Non-Working,Agency out of pocket,0,0,0,0,0,0,0
LAB North,Nicaragua,2025,Energy Drinks,Adrenaline,Pull-Non-Working,All Other Non-Working,CP out of pocket admin,0,0,0,0,0,0,0
LAB North,Nicaragua,2025,Energy Drinks,Adrenaline,Pull-Non-Working,All Other Non-Working,Grassroots/experiential out of pocket,0,0,0,0,0,0,0
LAB North,Nicaragua,2025,Energy Drinks,Adrenaline,Pull-Non-Working,All Other Non-Working,League/property- rights fee/options,0,0,0,0,0,0,0
LAB North,Nicaragua,2025,Energy Drinks,Adrenaline,Pull-Non-Working,All Other Non-Working,Market Research,0,0,0,0,0,0,0
LAB North,Nicaragua,2025,Energy Drinks,Adrenaline,Pull-Non-Working,All Other Non-Working,Non-allocated NW,0,0,0,0,0,0,0
LAB North,Nicaragua,2025,Energy Drinks,Adrenaline,Pull-Non-Working,All Other Non-Working,Other Non Working-non itemised talent,0,0,0,0,0,0,0
LAB North,Nicaragua,2025,Energy Drinks,Adrenaline,Pull-Non-Working,All Other Non-Working,PR out of pocket administrative,0,0,0,0,0,0,0
LAB North,Nicaragua,2025,Energy Drinks,Adrenaline,Pull-Non-Working,Innovation and Insight,Innovations,0,0,0,0,0,0,0
LAB North,Nicaragua,2025,Energy Drinks,Adrenaline,Pull-Non-Working,Innovation and Insight,Market Research,0,0,0,0,0,0,0
LAB North,Nicaragua,2025,Energy Drinks,Adrenaline,Pull-Non-Working,Package Design,Package design,0,0,0,0,0,0,0
LAB North,Nicaragua,2025,Energy Drinks,Adrenaline,Pull-Non-Working,Package Design,Package development,0,0,0,0,0,0,0
LAB North,Nicaragua,2025,Energy Drinks,Adrenaline,STB - Push,Capability Building/Other,Capability Building Other,0,0,0,0,0,0,0
LAB North,Nicaragua,2025,Energy Drinks,Adrenaline,STB - Push,Other Investments,CDA's,50,5999,2999,3000,164,82,82
LAB North,Nicaragua,2025,Energy Drinks,Adrenaline,STB - Push,Other Investments,Capital (Coolers),0,0,0,0,0,0,0
LAB North,Nicaragua,2025,Energy Drinks,Adrenaline,STB - Push,Other Investments,Price Support,0,0,0,0,0,0,0
LAB North,Nicaragua,2025,Energy Drinks,Adrenaline,STB - Push,Other Investments,Vending / Racks,0,0,0,0,0,0,0
LAB North,Nicaragua,2025,Energy Drinks,Adrenaline,STB - Push,Other Trade,Frozen Funds,0,0,0,0,0,0,0
LAB North,Nicaragua,2025,Energy Drinks,Adrenaline,STB - Push,Other Trade,Other Trade,0,0,0,0,0,0,0
LAB North,Nicaragua,2025,Energy Drinks,Adrenaline,STB - Push,Trade Equipment,Coolers - New,0,0,0,0,0,0,0
LAB North,Nicaragua,2025,Energy Drinks,Adrenaline,STB - Push,Trade Equipment,Coolers - Refurbished,0,0,0,0,0,0,0
LAB North,Nicaragua,2025,Energy Drinks,Adrenaline,STB - Push,Trade Equipment,Post Mix / Pre Mix Equip.,0,0,0,0,0,0,0
LAB North,Nicaragua,2025,Energy Drinks,Adrenaline,STB - Push,Trade Equipment,Vending / Racks,0,0,0,0,0,0,0
LAB North,Nicaragua,2025,Energy Drinks,Adrenaline,STB - Push,Trade Programs,Distribution Incentives,0,0,0,0,0,0,0
LAB North,Nicaragua,2025,Energy Drinks,Adrenaline,STB - Push,Trade Programs,Innovation Investments,0,0,0,0,0,0,0
LAB North,Nicaragua,2025,Energy Drinks,Adrenaline,STB - Push,Trade Programs,Sales Incentives,0,0,0,0,0,0,0
LAB North,Nicaragua,2025,Energy Drinks,Adrenaline,STB - Push,Trade Programs,Space Investments,0,0,0,0,0,0,0
LAB North,Nicaragua,2025,Energy Drinks,Adrenaline,Pull-Working,All Other Working,Other Working - PR execution,50,53000,26500,26500,1449,724,725
LAB North,Nicaragua,2025,Energy Drinks,Adrenaline,Pull-Working,All Other Working,Other Working - activation,0,0,0,0,0,0,0
LAB North,Nicaragua,2025,Energy Drinks,Adrenaline,Pull-Working,All Other Working,Other Working - non allocated working,0,0,0,0,0,0,0
LAB North,Nicaragua,2025,Energy Drinks,Adrenaline,Pull-Working,Consumer Promotions,Consumer Promotions Execution,0,0,0,0,0,0,0
LAB North,Nicaragua,2025,Energy Drinks,Adrenaline,Pull-Working,Consumer Promotions,Coupons,0,0,0,0,0,0,0
LAB North,Nicaragua,2025,Energy Drinks,Adrenaline,Pull-Working,Consumer Promotions,Other,0,0,0,0,0,0,0
LAB North,Nicaragua,2025,Energy Drinks,Adrenaline,Pull-Working,Consumer Promotions,Premiums,50,9999,4999,5000,273,136,137
LAB North,Nicaragua,2025,Energy Drinks,Adrenaline,Pull-Working,In Store & POS Execution,In-Store & POS Execution,50,4000,2000,2000,109,54,55
LAB North,Nicaragua,2025,Energy Drinks,Adrenaline,Pull-Working,Media Placements,Cinema,0,0,0,0,0,0,0
LAB North,Nicaragua,2025,Energy Drinks,Adrenaline,Pull-Working,Media Placements,Digital,0,0,0,0,0,0,0
LAB North,Nicaragua,2025,Energy Drinks,Adrenaline,Pull-Working,Media Placements,OOH - Out Of Home,0,0,0,0,0,0,0
LAB North,Nicaragua,2025,Energy Drinks,Adrenaline,Pull-Working,Media Placements,Other,0,0,0,0,0,0,0
LAB North,Nicaragua,2025,Energy Drinks,Adrenaline,Pull-Working,Media Placements,Print,50,15999,7999,8000,437,218,219
LAB North,Nicaragua,2025,Energy Drinks,Adrenaline,Pull-Working,Media Placements,Radio,0,0,0,0,0,0,0
LAB North,Nicaragua,2025,Energy Drinks,Adrenaline,Pull-Working,Media Placements,TV,0,0,0,0,0,0,0
LAB North,Nicaragua,2025,Energy Drinks,Adrenaline,Pull-Working,Sampling,Product Samples,50,17999,8999,9000,492,246,246
LAB North,Nicaragua,2025,Energy Drinks,Adrenaline,Pull-Working,Sampling,Sampling Execution,0,0,0,0,0,0,0
LAB North,Nicaragua,2025,Energy Drinks,Adrenaline,Pull-Working,Sponsorships,Sponsorships-in game/ in show,50,4000,2000,2000,109,54,55
LAB North,Nicaragua,2025,Energy Drinks,Adrenaline,Pull-Working,Sponsorships,Sports-athlete/team contracts,0,0,0,0,0,0,0
LAB North,Nicaragua,2025,Energy Drinks,Adrenaline,Pull-Working,Sponsorships,Sports-on field or in show props,0,0,0,0,0,0,0
LAB North,Nicaragua,2025,Energy Drinks,Adrenaline,Pull-Working,Sponsorships,Sports-stadium contracts,0,0,0,0,0,0,0
LAB North,Nicaragua,2025,Water,Aquafina,Pull-Non-Working,Ad Production,Digital Ad Production,0,0,0,0,0,0,0
LAB North,Nicaragua,2025,Water,Aquafina,Pull-Non-Working,Ad Production,"TV, Print, Radio, OOH, Production",0,0,0,0,0,0,0
LAB North,Nicaragua,2025,Water,Aquafina,Pull-Non-Working,Agency Fees,Creative Agency Fees,0,0,0,0,0,0,0
LAB North,Nicaragua,2025,Water,Aquafina,Pull-Non-Working,Agency Fees,In Store & POS Design / Development,0,0,0,0,0,0,0
LAB North,Nicaragua,2025,Water,Aquafina,Pull-Non-Working,Agency Fees,Media Agency Fees,0,0,0,0,0,0,0
LAB North,Nicaragua,2025,Water,Aquafina,Pull-Non-Working,Agency Fees,Other,0,0,0,0,0,0,0
LAB North,Nicaragua,2025,Water,Aquafina,Pull-Non-Working,Agency Fees,Social Media / Influence Marketing,0,0,0,0,0,0,0
LAB North,Nicaragua,2025,Water,Aquafina,Pull-Non-Working,All Other Non-Working,Administrative fees,0,0,0,0,0,0,0
LAB North,Nicaragua,2025,Water,Aquafina,Pull-Non-Working,All Other Non-Working,Agency out of pocket,0,0,0,0,0,0,0
LAB North,Nicaragua,2025,Water,Aquafina,Pull-Non-Working,All Other Non-Working,CP out of pocket admin,0,0,0,0,0,0,0
LAB North,Nicaragua,2025,Water,Aquafina,Pull-Non-Working,All Other Non-Working,Grassroots/experiential out of pocket,0,0,0,0,0,0,0
LAB North,Nicaragua,2025,Water,Aquafina,Pull-Non-Working,All Other Non-Working,League/property- rights fee/options,0,0,0,0,0,0,0
LAB North,Nicaragua,2025,Water,Aquafina,Pull-Non-Working,All Other Non-Working,Market Research,0,0,0,0,0,0,0
LAB North,Nicaragua,2025,Water,Aquafina,Pull-Non-Working,All Other Non-Working,Non-allocated NW,0,0,0,0,0,0,0
LAB North,Nicaragua,2025,Water,Aquafina,Pull-Non-Working,All Other Non-Working,Other Non Working-non itemised talent,0,0,0,0,0,0,0
LAB North,Nicaragua,2025,Water,Aquafina,Pull-Non-Working,All Other Non-Working,PR out of pocket administrative,0,0,0,0,0,0,0
LAB North,Nicaragua,2025,Water,Aquafina,Pull-Non-Working,Innovation and Insight,Innovations,0,0,0,0,0,0,0
LAB North,Nicaragua,2025,Water,Aquafina,Pull-Non-Working,Innovation and Insight,Market Research,50,1999,999,1000,54,27,27
LAB North,Nicaragua,2025,Water,Aquafina,Pull-Non-Working,Package Design,Package design,0,0,0,0,0,0,0
LAB North,Nicaragua,2025,Water,Aquafina,Pull-Non-Working,Package Design,Package development,0,0,0,0,0,0,0
LAB North,Nicaragua,2025,Water,Aquafina,STB - Push,Capability Building/Other,Capability Building Other,0,0,0,0,0,0,0
LAB North,Nicaragua,2025,Water,Aquafina,STB - Push,Other Investments,CDA's,50,26999,13499,13500,738,369,369
LAB North,Nicaragua,2025,Water,Aquafina,STB - Push,Other Investments,Capital (Coolers),0,0,0,0,0,0,0
LAB North,Nicaragua,2025,Water,Aquafina,STB - Push,Other Investments,Price Support,0,0,0,0,0,0,0
LAB North,Nicaragua,2025,Water,Aquafina,STB - Push,Other Investments,Vending / Racks,0,0,0,0,0,0,0
LAB North,Nicaragua,2025,Water,Aquafina,STB - Push,Other Trade,Frozen Funds,0,0,0,0,0,0,0
LAB North,Nicaragua,2025,Water,Aquafina,STB - Push,Other Trade,Other Trade,0,0,0,0,0,0,0
LAB North,Nicaragua,2025,Water,Aquafina,STB - Push,Trade Equipment,Coolers - New,0,0,0,0,0,0,0
LAB North,Nicaragua,2025,Water,Aquafina,STB - Push,Trade Equipment,Coolers - Refurbished,0,0,0,0,0,0,0
LAB North,Nicaragua,2025,Water,Aquafina,STB - Push,Trade Equipment,Post Mix / Pre Mix Equip.,0,0,0,0,0,0,0
LAB North,Nicaragua,2025,Water,Aquafina,STB - Push,Trade Equipment,Vending / Racks,0,0,0,0,0,0,0
LAB North,Nicaragua,2025,Water,Aquafina,STB - Push,Trade Programs,Distribution Incentives,0,0,0,0,0,0,0
LAB North,Nicaragua,2025,Water,Aquafina,STB - Push,Trade Programs,Innovation Investments,0,0,0,0,0,0,0
LAB North,Nicaragua,2025,Water,Aquafina,STB - Push,Trade Programs,Sales Incentives,0,0,0,0,0,0,0
LAB North,Nicaragua,2025,Water,Aquafina,STB - Push,Trade Programs,Space Investments,0,0,0,0,0,0,0
LAB North,Nicaragua,2025,Water,Aquafina,Pull-Working,All Other Working,Other Working - PR execution,50,69999,34999,35000,1914,957,957
LAB North,Nicaragua,2025,Water,Aquafina,Pull-Working,All Other Working,Other Working - activation,0,0,0,0,0,0,0
LAB North,Nicaragua,2025,Water,Aquafina,Pull-Working,All Other Working,Other Working - non allocated working,0,0,0,0,0,0,0
LAB North,Nicaragua,2025,Water,Aquafina,Pull-Working,Consumer Promotions,Consumer Promotions Execution,0,0,0,0,0,0,0
LAB North,Nicaragua,2025,Water,Aquafina,Pull-Working,Consumer Promotions,Coupons,0,0,0,0,0,0,0
LAB North,Nicaragua,2025,Water,Aquafina,Pull-Working,Consumer Promotions,Other,0,0,0,0,0,0,0
LAB North,Nicaragua,2025,Water,Aquafina,Pull-Working,Consumer Promotions,Premiums,50,39999,19999,20000,1093,546,547
LAB North,Nicaragua,2025,Water,Aquafina,Pull-Working,In Store & POS Execution,In-Store & POS Execution,50,39999,19999,20000,1093,546,547
LAB North,Nicaragua,2025,Water,Aquafina,Pull-Working,Media Placements,Cinema,0,0,0,0,0,0,0
LAB North,Nicaragua,2025,Water,Aquafina,Pull-Working,Media Placements,Digital,50,4999,2499,2500,136,68,68
LAB North,Nicaragua,2025,Water,Aquafina,Pull-Working,Media Placements,OOH - Out Of Home,0,0,0,0,0,0,0
LAB North,Nicaragua,2025,Water,Aquafina,Pull-Working,Media Placements,Other,0,0,0,0,0,0,0
LAB North,Nicaragua,2025,Water,Aquafina,Pull-Working,Media Placements,Print,50,39999,19999,20000,1093,546,547
LAB North,Nicaragua,2025,Water,Aquafina,Pull-Working,Media Placements,Radio,0,0,0,0,0,0,0
LAB North,Nicaragua,2025,Water,Aquafina,Pull-Working,Media Placements,TV,0,0,0,0,0,0,0
LAB North,Nicaragua,2025,Water,Aquafina,Pull-Working,Sampling,Product Samples,50,20000,10000,10000,546,273,273
LAB North,Nicaragua,2025,Water,Aquafina,Pull-Working,Sampling,Sampling Execution,0,0,0,0,0,0,0
LAB North,Nicaragua,2025,Water,Aquafina,Pull-Working,Sponsorships,Sponsorships-in game/ in show,50,39999,19999,20000,1093,546,547
LAB North,Nicaragua,2025,Water,Aquafina,Pull-Working,Sponsorships,Sports-athlete/team contracts,0,0,0,0,0,0,0
LAB North,Nicaragua,2025,Water,Aquafina,Pull-Working,Sponsorships,Sports-on field or in show props,0,0,0,0,0,0,0
LAB North,Nicaragua,2025,Water,Aquafina,Pull-Working,Sponsorships,Sports-stadium contracts,0,0,0,0,0,0,0
LAB North,Nicaragua,2025,Energy Drinks,Kickstart,Pull-Non-Working,Ad Production,Digital Ad Production,0,0,0,0,0,0,0
LAB North,Nicaragua,2025,Energy Drinks,Kickstart,Pull-Non-Working,Ad Production,"TV, Print, Radio, OOH, Production",0,0,0,0,0,0,0
LAB North,Nicaragua,2025,Energy Drinks,Kickstart,Pull-Non-Working,Agency Fees,Creative Agency Fees,0,0,0,0,0,0,0
LAB North,Nicaragua,2025,Energy Drinks,Kickstart,Pull-Non-Working,Agency Fees,In Store & POS Design / Development,0,0,0,0,0,0,0
LAB North,Nicaragua,2025,Energy Drinks,Kickstart,Pull-Non-Working,Agency Fees,Media Agency Fees,0,0,0,0,0,0,0
LAB North,Nicaragua,2025,Energy Drinks,Kickstart,Pull-Non-Working,Agency Fees,Other,0,0,0,0,0,0,0
LAB North,Nicaragua,2025,Energy Drinks,Kickstart,Pull-Non-Working,Agency Fees,Social Media / Influence Marketing,0,0,0,0,0,0,0
LAB North,Nicaragua,2025,Energy Drinks,Kickstart,Pull-Non-Working,All Other Non-Working,Administrative fees,0,0,0,0,0,0,0
LAB North,Nicaragua,2025,Energy Drinks,Kickstart,Pull-Non-Working,All Other Non-Working,Agency out of pocket,0,0,0,0,0,0,0
LAB North,Nicaragua,2025,Energy Drinks,Kickstart,Pull-Non-Working,All Other Non-Working,CP out of pocket admin,0,0,0,0,0,0,0
LAB North,Nicaragua,2025,Energy Drinks,Kickstart,Pull-Non-Working,All Other Non-Working,Grassroots/experiential out of pocket,0,0,0,0,0,0,0
LAB North,Nicaragua,2025,Energy Drinks,Kickstart,Pull-Non-Working,All Other Non-Working,League/property- rights fee/options,0,0,0,0,0,0,0
LAB North,Nicaragua,2025,Energy Drinks,Kickstart,Pull-Non-Working,All Other Non-Working,Market Research,0,0,0,0,0,0,0
LAB North,Nicaragua,2025,Energy Drinks,Kickstart,Pull-Non-Working,All Other Non-Working,Non-allocated NW,0,0,0,0,0,0,0
LAB North,Nicaragua,2025,Energy Drinks,Kickstart,Pull-Non-Working,All Other Non-Working,Other Non Working-non itemised talent,0,0,0,0,0,0,0
LAB North,Nicaragua,2025,Energy Drinks,Kickstart,Pull-Non-Working,All Other Non-Working,PR out of pocket administrative,0,0,0,0,0,0,0
LAB North,Nicaragua,2025,Energy Drinks,Kickstart,Pull-Non-Working,Innovation and Insight,Innovations,0,0,0,0,0,0,0
LAB North,Nicaragua,2025,Energy Drinks,Kickstart,Pull-Non-Working,Innovation and Insight,Market Research,0,0,0,0,0,0,0
LAB North,Nicaragua,2025,Energy Drinks,Kickstart,Pull-Non-Working,Package Design,Package design,0,0,0,0,0,0,0
LAB North,Nicaragua,2025,Energy Drinks,Kickstart,Pull-Non-Working,Package Design,Package development,0,0,0,0,0,0,0
LAB North,Nicaragua,2025,Energy Drinks,Kickstart,STB - Push,Capability Building/Other,Capability Building Other,0,0,0,0,0,0,0
LAB North,Nicaragua,2025,Energy Drinks,Kickstart,STB - Push,Other Investments,CDA's,50,32000,16000,16000,875,437,438
LAB North,Nicaragua,2025,Energy Drinks,Kickstart,STB - Push,Other Investments,Capital (Coolers),0,0,0,0,0,0,0
LAB North,Nicaragua,2025,Energy Drinks,Kickstart,STB - Push,Other Investments,Price Support,0,0,0,0,0,0,0
LAB North,Nicaragua,2025,Energy Drinks,Kickstart,STB - Push,Other Investments,Vending / Racks,0,0,0,0,0,0,0
LAB North,Nicaragua,2025,Energy Drinks,Kickstart,STB - Push,Other Trade,Frozen Funds,0,0,0,0,0,0,0
LAB North,Nicaragua,2025,Energy Drinks,Kickstart,STB - Push,Other Trade,Other Trade,0,0,0,0,0,0,0
LAB North,Nicaragua,2025,Energy Drinks,Kickstart,STB - Push,Trade Equipment,Coolers - New,0,0,0,0,0,0,0
LAB North,Nicaragua,2025,Energy Drinks,Kickstart,STB - Push,Trade Equipment,Coolers - Refurbished,0,0,0,0,0,0,0
LAB North,Nicaragua,2025,Energy Drinks,Kickstart,STB - Push,Trade Equipment,Post Mix / Pre Mix Equip.,0,0,0,0,0,0,0
LAB North,Nicaragua,2025,Energy Drinks,Kickstart,STB - Push,Trade Equipment,Vending / Racks,0,0,0,0,0,0,0
LAB North,Nicaragua,2025,Energy Drinks,Kickstart,STB - Push,Trade Programs,Distribution Incentives,0,0,0,0,0,0,0
LAB North,Nicaragua,2025,Energy Drinks,Kickstart,STB - Push,Trade Programs,Innovation Investments,0,0,0,0,0,0,0
LAB North,Nicaragua,2025,Energy Drinks,Kickstart,STB - Push,Trade Programs,Sales Incentives,0,0,0,0,0,0,0
LAB North,Nicaragua,2025,Energy Drinks,Kickstart,STB - Push,Trade Programs,Space Investments,0,0,0,0,0,0,0
LAB North,Nicaragua,2025,Energy Drinks,Kickstart,Pull-Working,All Other Working,Other Working - PR execution,0,0,0,0,0,0,0
LAB North,Nicaragua,2025,Energy Drinks,Kickstart,Pull-Working,All Other Working,Other Working - activation,0,0,0,0,0,0,0
LAB North,Nicaragua,2025,Energy Drinks,Kickstart,Pull-Working,All Other Working,Other Working - non allocated working,0,0,0,0,0,0,0
LAB North,Nicaragua,2025,Energy Drinks,Kickstart,Pull-Working,Consumer Promotions,Consumer Promotions Execution,0,0,0,0,0,0,0
LAB North,Nicaragua,2025,Energy Drinks,Kickstart,Pull-Working,Consumer Promotions,Coupons,0,0,0,0,0,0,0
LAB North,Nicaragua,2025,Energy Drinks,Kickstart,Pull-Working,Consumer Promotions,Other,0,0,0,0,0,0,0
LAB North,Nicaragua,2025,Energy Drinks,Kickstart,Pull-Working,Consumer Promotions,Premiums,0,0,0,0,0,0,0
LAB North,Nicaragua,2025,Energy Drinks,Kickstart,Pull-Working,In Store & POS Execution,In-Store & POS Execution,0,0,0,0,0,0,0
LAB North,Nicaragua,2025,Energy Drinks,Kickstart,Pull-Working,Media Placements,Cinema,0,0,0,0,0,0,0
LAB North,Nicaragua,2025,Energy Drinks,Kickstart,Pull-Working,Media Placements,Digital,0,0,0,0,0,0,0
LAB North,Nicaragua,2025,Energy Drinks,Kickstart,Pull-Working,Media Placements,OOH - Out Of Home,0,0,0,0,0,0,0
LAB North,Nicaragua,2025,Energy Drinks,Kickstart,Pull-Working,Media Placements,Other,0,0,0,0,0,0,0
LAB North,Nicaragua,2025,Energy Drinks,Kickstart,Pull-Working,Media Placements,Print,0,0,0,0,0,0,0
LAB North,Nicaragua,2025,Energy Drinks,Kickstart,Pull-Working,Media Placements,Radio,0,0,0,0,0,0,0
LAB North,Nicaragua,2025,Energy Drinks,Kickstart,Pull-Working,Media Placements,TV,0,0,0,0,0,0,0
LAB North,Nicaragua,2025,Energy Drinks,Kickstart,Pull-Working,Sampling,Product Samples,0,0,0,0,0,0,0
LAB North,Nicaragua,2025,Energy Drinks,Kickstart,Pull-Working,Sampling,Sampling Execution,0,0,0,0,0,0,0
LAB North,Nicaragua,2025,Energy Drinks,Kickstart,Pull-Working,Sponsorships,Sponsorships-in game/ in show,0,0,0,0,0,0,0
LAB North,Nicaragua,2025,Energy Drinks,Kickstart,Pull-Working,Sponsorships,Sports-athlete/team contracts,0,0,0,0,0,0,0
LAB North,Nicaragua,2025,Energy Drinks,Kickstart,Pull-Working,Sponsorships,Sports-on field or in show props,0,0,0,0,0,0,0
LAB North,Nicaragua,2025,Energy Drinks,Kickstart,Pull-Working,Sponsorships,Sports-stadium contracts,0,0,0,0,0,0,0
LAB North,Nicaragua,2025,RTD Tea,Lipton,Pull-Non-Working,Ad Production,Digital Ad Production,0,0,0,0,0,0,0
LAB North,Nicaragua,2025,RTD Tea,Lipton,Pull-Non-Working,Ad Production,"TV, Print, Radio, OOH, Production",0,0,0,0,0,0,0
LAB North,Nicaragua,2025,RTD Tea,Lipton,Pull-Non-Working,Agency Fees,Creative Agency Fees,0,0,0,0,0,0,0
LAB North,Nicaragua,2025,RTD Tea,Lipton,Pull-Non-Working,Agency Fees,In Store & POS Design / Development,0,0,0,0,0,0,0
LAB North,Nicaragua,2025,RTD Tea,Lipton,Pull-Non-Working,Agency Fees,Media Agency Fees,0,0,0,0,0,0,0
LAB North,Nicaragua,2025,RTD Tea,Lipton,Pull-Non-Working,Agency Fees,Other,0,0,0,0,0,0,0
LAB North,Nicaragua,2025,RTD Tea,Lipton,Pull-Non-Working,Agency Fees,Social Media / Influence Marketing,0,0,0,0,0,0,0
LAB North,Nicaragua,2025,RTD Tea,Lipton,Pull-Non-Working,All Other Non-Working,Administrative fees,0,0,0,0,0,0,0
LAB North,Nicaragua,2025,RTD Tea,Lipton,Pull-Non-Working,All Other Non-Working,Agency out of pocket,0,0,0,0,0,0,0
LAB North,Nicaragua,2025,RTD Tea,Lipton,Pull-Non-Working,All Other Non-Working,CP out of pocket admin,0,0,0,0,0,0,0
LAB North,Nicaragua,2025,RTD Tea,Lipton,Pull-Non-Working,All Other Non-Working,Grassroots/experiential out of pocket,0,0,0,0,0,0,0
LAB North,Nicaragua,2025,RTD Tea,Lipton,Pull-Non-Working,All Other Non-Working,League/property- rights fee/options,0,0,0,0,0,0,0
LAB North,Nicaragua,2025,RTD Tea,Lipton,Pull-Non-Working,All Other Non-Working,Market Research,0,0,0,0,0,0,0
LAB North,Nicaragua,2025,RTD Tea,Lipton,Pull-Non-Working,All Other Non-Working,Non-allocated NW,0,0,0,0,0,0,0
LAB North,Nicaragua,2025,RTD Tea,Lipton,Pull-Non-Working,All Other Non-Working,Other Non Working-non itemised talent,0,0,0,0,0,0,0
LAB North,Nicaragua,2025,RTD Tea,Lipton,Pull-Non-Working,All Other Non-Working,PR out of pocket administrative,0,0,0,0,0,0,0
LAB North,Nicaragua,2025,RTD Tea,Lipton,Pull-Non-Working,Innovation and Insight,Innovations,0,0,0,0,0,0,0
LAB North,Nicaragua,2025,RTD Tea,Lipton,Pull-Non-Working,Innovation and Insight,Market Research,0,0,0,0,0,0,0
LAB North,Nicaragua,2025,RTD Tea,Lipton,Pull-Non-Working,Package Design,Package design,0,0,0,0,0,0,0
LAB North,Nicaragua,2025,RTD Tea,Lipton,Pull-Non-Working,Package Design,Package development,0,0,0,0,0,0,0
LAB North,Nicaragua,2025,RTD Tea,Lipton,STB - Push,Capability Building/Other,Capability Building Other,0,0,0,0,0,0,0
LAB North,Nicaragua,2025,RTD Tea,Lipton,STB - Push,Other Investments,CDA's,50,30999,15499,15500,847,423,424
LAB North,Nicaragua,2025,RTD Tea,Lipton,STB - Push,Other Investments,Capital (Coolers),0,0,0,0,0,0,0
LAB North,Nicaragua,2025,RTD Tea,Lipton,STB - Push,Other Investments,Price Support,0,0,0,0,0,0,0
LAB North,Nicaragua,2025,RTD Tea,Lipton,STB - Push,Other Investments,Vending / Racks,0,0,0,0,0,0,0
LAB North,Nicaragua,2025,RTD Tea,Lipton,STB - Push,Other Trade,Frozen Funds,0,0,0,0,0,0,0
LAB North,Nicaragua,2025,RTD Tea,Lipton,STB - Push,Other Trade,Other Trade,0,0,0,0,0,0,0
LAB North,Nicaragua,2025,RTD Tea,Lipton,STB - Push,Trade Equipment,Coolers - New,0,0,0,0,0,0,0
LAB North,Nicaragua,2025,RTD Tea,Lipton,STB - Push,Trade Equipment,Coolers - Refurbished,0,0,0,0,0,0,0
LAB North,Nicaragua,2025,RTD Tea,Lipton,STB - Push,Trade Equipment,Post Mix / Pre Mix Equip.,0,0,0,0,0,0,0
LAB North,Nicaragua,2025,RTD Tea,Lipton,STB - Push,Trade Equipment,Vending / Racks,0,0,0,0,0,0,0
LAB North,Nicaragua,2025,RTD Tea,Lipton,STB - Push,Trade Programs,Distribution Incentives,0,0,0,0,0,0,0
LAB North,Nicaragua,2025,RTD Tea,Lipton,STB - Push,Trade Programs,Innovation Investments,0,0,0,0,0,0,0
LAB North,Nicaragua,2025,RTD Tea,Lipton,STB - Push,Trade Programs,Sales Incentives,0,0,0,0,0,0,0
LAB North,Nicaragua,2025,RTD Tea,Lipton,STB - Push,Trade Programs,Space Investments,0,0,0,0,0,0,0
LAB North,Nicaragua,2025,RTD Tea,Lipton,Pull-Working,All Other Working,Other Working - PR execution,50,32000,16000,16000,875,437,438
LAB North,Nicaragua,2025,RTD Tea,Lipton,Pull-Working,All Other Working,Other Working - activation,0,0,0,0,0,0,0
LAB North,Nicaragua,2025,RTD Tea,Lipton,Pull-Working,All Other Working,Other Working - non allocated working,0,0,0,0,0,0,0
LAB North,Nicaragua,2025,RTD Tea,Lipton,Pull-Working,Consumer Promotions,Consumer Promotions Execution,0,0,0,0,0,0,0
LAB North,Nicaragua,2025,RTD Tea,Lipton,Pull-Working,Consumer Promotions,Coupons,0,0,0,0,0,0,0
LAB North,Nicaragua,2025,RTD Tea,Lipton,Pull-Working,Consumer Promotions,Other,0,0,0,0,0,0,0
LAB North,Nicaragua,2025,RTD Tea,Lipton,Pull-Working,Consumer Promotions,Premiums,50,20000,10000,10000,546,273,273
LAB North,Nicaragua,2025,RTD Tea,Lipton,Pull-Working,In Store & POS Execution,In-Store & POS Execution,50,9999,4999,5000,273,136,137
LAB North,Nicaragua,2025,RTD Tea,Lipton,Pull-Working,Media Placements,Cinema,0,0,0,0,0,0,0
LAB North,Nicaragua,2025,RTD Tea,Lipton,Pull-Working,Media Placements,Digital,50,9999,4999,5000,273,136,137
LAB North,Nicaragua,2025,RTD Tea,Lipton,Pull-Working,Media Placements,OOH - Out Of Home,0,0,0,0,0,0,0
LAB North,Nicaragua,2025,RTD Tea,Lipton,Pull-Working,Media Placements,Other,0,0,0,0,0,0,0
LAB North,Nicaragua,2025,RTD Tea,Lipton,Pull-Working,Media Placements,Print,50,35999,17999,18000,984,492,492
LAB North,Nicaragua,2025,RTD Tea,Lipton,Pull-Working,Media Placements,Radio,0,0,0,0,0,0,0
LAB North,Nicaragua,2025,RTD Tea,Lipton,Pull-Working,Media Placements,TV,0,0,0,0,0,0,0
LAB North,Nicaragua,2025,RTD Tea,Lipton,Pull-Working,Sampling,Product Samples,50,15000,7500,7500,410,205,205
LAB North,Nicaragua,2025,RTD Tea,Lipton,Pull-Working,Sampling,Sampling Execution,0,0,0,0,0,0,0
LAB North,Nicaragua,2025,RTD Tea,Lipton,Pull-Working,Sponsorships,Sponsorships-in game/ in show,0,0,0,0,0,0,0
LAB North,Nicaragua,2025,RTD Tea,Lipton,Pull-Working,Sponsorships,Sports-athlete/team contracts,0,0,0,0,0,0,0
LAB North,Nicaragua,2025,RTD Tea,Lipton,Pull-Working,Sponsorships,Sports-on field or in show props,0,0,0,0,0,0,0
LAB North,Nicaragua,2025,RTD Tea,Lipton,Pull-Working,Sponsorships,Sports-stadium contracts,0,0,0,0,0,0,0
LAB North,Nicaragua,2025,CSD,Pepsi,Pull-Non-Working,Ad Production,Digital Ad Production,0,0,0,0,0,0,0
LAB North,Nicaragua,2025,CSD,Pepsi,Pull-Non-Working,Ad Production,"TV, Print, Radio, OOH, Production",0,0,0,0,0,0,0
LAB North,Nicaragua,2025,CSD,Pepsi,Pull-Non-Working,Agency Fees,Creative Agency Fees,0,0,0,0,0,0,0
LAB North,Nicaragua,2025,CSD,Pepsi,Pull-Non-Working,Agency Fees,In Store & POS Design / Development,0,0,0,0,0,0,0
LAB North,Nicaragua,2025,CSD,Pepsi,Pull-Non-Working,Agency Fees,Media Agency Fees,0,0,0,0,0,0,0
LAB North,Nicaragua,2025,CSD,Pepsi,Pull-Non-Working,Agency Fees,Other,0,0,0,0,0,0,0
LAB North,Nicaragua,2025,CSD,Pepsi,Pull-Non-Working,Agency Fees,Social Media / Influence Marketing,0,0,0,0,0,0,0
LAB North,Nicaragua,2025,CSD,Pepsi,Pull-Non-Working,All Other Non-Working,Administrative fees,0,0,0,0,0,0,0
LAB North,Nicaragua,2025,CSD,Pepsi,Pull-Non-Working,All Other Non-Working,Agency out of pocket,0,0,0,0,0,0,0
LAB North,Nicaragua,2025,CSD,Pepsi,Pull-Non-Working,All Other Non-Working,CP out of pocket admin,0,0,0,0,0,0,0
LAB North,Nicaragua,2025,CSD,Pepsi,Pull-Non-Working,All Other Non-Working,Grassroots/experiential out of pocket,0,0,0,0,0,0,0
LAB North,Nicaragua,2025,CSD,Pepsi,Pull-Non-Working,All Other Non-Working,League/property- rights fee/options,0,0,0,0,0,0,0
LAB North,Nicaragua,2025,CSD,Pepsi,Pull-Non-Working,All Other Non-Working,Market Research,0,0,0,0,0,0,0
LAB North,Nicaragua,2025,CSD,Pepsi,Pull-Non-Working,All Other Non-Working,Non-allocated NW,0,0,0,0,0,0,0
LAB North,Nicaragua,2025,CSD,Pepsi,Pull-Non-Working,All Other Non-Working,Other Non Working-non itemised talent,0,0,0,0,0,0,0
LAB North,Nicaragua,2025,CSD,Pepsi,Pull-Non-Working,All Other Non-Working,PR out of pocket administrative,0,0,0,0,0,0,0
LAB North,Nicaragua,2025,CSD,Pepsi,Pull-Non-Working,Innovation and Insight,Innovations,0,0,0,0,0,0,0
LAB North,Nicaragua,2025,CSD,Pepsi,Pull-Non-Working,Innovation and Insight,Market Research,50,140000,70000,70000,3828,1914,1914
LAB North,Nicaragua,2025,CSD,Pepsi,Pull-Non-Working,Package Design,Package design,0,0,0,0,0,0,0
LAB North,Nicaragua,2025,CSD,Pepsi,Pull-Non-Working,Package Design,Package development,0,0,0,0,0,0,0
LAB North,Nicaragua,2025,CSD,Pepsi,STB - Push,Capability Building/Other,Capability Building Other,0,0,0,0,0,0,0
LAB North,Nicaragua,2025,CSD,Pepsi,STB - Push,Other Investments,CDA's,50,4716759,2358379,2358380,128974,64487,64487
LAB North,Nicaragua,2025,CSD,Pepsi,STB - Push,Other Investments,Capital (Coolers),0,0,0,0,0,0,0
LAB North,Nicaragua,2025,CSD,Pepsi,STB - Push,Other Investments,Price Support,50,142000,71000,71000,3882,1941,1941
LAB North,Nicaragua,2025,CSD,Pepsi,STB - Push,Other Investments,Vending / Racks,0,0,0,0,0,0,0
LAB North,Nicaragua,2025,CSD,Pepsi,STB - Push,Other Trade,Frozen Funds,0,0,0,0,0,0,0
LAB North,Nicaragua,2025,CSD,Pepsi,STB - Push,Other Trade,Other Trade,0,0,0,0,0,0,0
LAB North,Nicaragua,2025,CSD,Pepsi,STB - Push,Trade Equipment,Coolers - New,50,699999,349999,350000,19140,9570,9570
LAB North,Nicaragua,2025,CSD,Pepsi,STB - Push,Trade Equipment,Coolers - Refurbished,0,0,0,0,0,0,0
LAB North,Nicaragua,2025,CSD,Pepsi,STB - Push,Trade Equipment,Post Mix / Pre Mix Equip.,0,0,0,0,0,0,0
LAB North,Nicaragua,2025,CSD,Pepsi,STB - Push,Trade Equipment,Vending / Racks,50,55000,27500,27500,1503,751,752
LAB North,Nicaragua,2025,CSD,Pepsi,STB - Push,Trade Programs,Distribution Incentives,0,0,0,0,0,0,0
LAB North,Nicaragua,2025,CSD,Pepsi,STB - Push,Trade Programs,Innovation Investments,0,0,0,0,0,0,0
LAB North,Nicaragua,2025,CSD,Pepsi,STB - Push,Trade Programs,Sales Incentives,0,0,0,0,0,0,0
LAB North,Nicaragua,2025,CSD,Pepsi,STB - Push,Trade Programs,Space Investments,0,0,0,0,0,0,0
LAB North,Nicaragua,2025,CSD,Pepsi,Pull-Working,All Other Working,Other Working - PR execution,50,525000,262500,262500,14355,7177,7178
LAB North,Nicaragua,2025,CSD,Pepsi,Pull-Working,All Other Working,Other Working - activation,0,0,0,0,0,0,0
LAB North,Nicaragua,2025,CSD,Pepsi,Pull-Working,All Other Working,Other Working - non allocated working,0,0,0,0,0,0,0
LAB North,Nicaragua,2025,CSD,Pepsi,Pull-Working,Consumer Promotions,Consumer Promotions Execution,0,0,0,0,0,0,0
LAB North,Nicaragua,2025,CSD,Pepsi,Pull-Working,Consumer Promotions,Coupons,0,0,0,0,0,0,0
LAB North,Nicaragua,2025,CSD,Pepsi,Pull-Working,Consumer Promotions,Other,0,0,0,0,0,0,0
LAB North,Nicaragua,2025,CSD,Pepsi,Pull-Working,Consumer Promotions,Premiums,50,237999,118999,119000,6507,3253,3254
LAB North,Nicaragua,2025,CSD,Pepsi,Pull-Working,In Store & POS Execution,In-Store & POS Execution,50,159999,79999,80000,4374,2187,2187
LAB North,Nicaragua,2025,CSD,Pepsi,Pull-Working,Media Placements,Cinema,0,0,0,0,0,0,0
LAB North,Nicaragua,2025,CSD,Pepsi,Pull-Working,Media Placements,Digital,50,77000,38500,38500,2105,1052,1053
LAB North,Nicaragua,2025,CSD,Pepsi,Pull-Working,Media Placements,OOH - Out Of Home,0,0,0,0,0,0,0
LAB North,Nicaragua,2025,CSD,Pepsi,Pull-Working,Media Placements,Other,0,0,0,0,0,0,0
LAB North,Nicaragua,2025,CSD,Pepsi,Pull-Working,Media Placements,Print,50,151000,75500,75500,4128,2064,2064
LAB North,Nicaragua,2025,CSD,Pepsi,Pull-Working,Media Placements,Radio,0,0,0,0,0,0,0
LAB North,Nicaragua,2025,CSD,Pepsi,Pull-Working,Media Placements,TV,0,0,0,0,0,0,0
LAB North,Nicaragua,2025,CSD,Pepsi,Pull-Working,Sampling,Product Samples,50,79999,39999,40000,2187,1093,1094
LAB North,Nicaragua,2025,CSD,Pepsi,Pull-Working,Sampling,Sampling Execution,0,0,0,0,0,0,0
LAB North,Nicaragua,2025,CSD,Pepsi,Pull-Working,Sponsorships,Sponsorships-in game/ in show,50,40000,20000,20000,1093,546,547
LAB North,Nicaragua,2025,CSD,Pepsi,Pull-Working,Sponsorships,Sports-athlete/team contracts,0,0,0,0,0,0,0
LAB North,Nicaragua,2025,CSD,Pepsi,Pull-Working,Sponsorships,Sports-on field or in show props,0,0,0,0,0,0,0
LAB North,Nicaragua,2025,CSD,Pepsi,Pull-Working,Sponsorships,Sports-stadium contracts,0,0,0,0,0,0,0
LAB North,Puerto Rico,2025,Energy Drinks,AMP,Pull-Non-Working,Ad Production,Digital Ad Production,0,0,0,0,0,0,0
LAB North,Puerto Rico,2025,Energy Drinks,AMP,Pull-Non-Working,Ad Production,"TV, Print, Radio, OOH, Production",50,5213,2606,2607,5213,2606,2607
LAB North,Puerto Rico,2025,Energy Drinks,AMP,Pull-Non-Working,Agency Fees,Creative Agency Fees,0,0,0,0,0,0,0
LAB North,Puerto Rico,2025,Energy Drinks,AMP,Pull-Non-Working,Agency Fees,In Store & POS Design / Development,0,0,0,0,0,0,0
LAB North,Puerto Rico,2025,Energy Drinks,AMP,Pull-Non-Working,Agency Fees,Media Agency Fees,0,0,0,0,0,0,0
LAB North,Puerto Rico,2025,Energy Drinks,AMP,Pull-Non-Working,Agency Fees,Other,0,0,0,0,0,0,0
LAB North,Puerto Rico,2025,Energy Drinks,AMP,Pull-Non-Working,Agency Fees,Social Media / Influence Marketing,0,0,0,0,0,0,0
LAB North,Puerto Rico,2025,Energy Drinks,AMP,Pull-Non-Working,All Other Non-Working,Administrative fees,0,0,0,0,0,0,0
LAB North,Puerto Rico,2025,Energy Drinks,AMP,Pull-Non-Working,All Other Non-Working,Agency out of pocket,0,0,0,0,0,0,0
LAB North,Puerto Rico,2025,Energy Drinks,AMP,Pull-Non-Working,All Other Non-Working,CP out of pocket admin,0,0,0,0,0,0,0
LAB North,Puerto Rico,2025,Energy Drinks,AMP,Pull-Non-Working,All Other Non-Working,Grassroots/experiential out of pocket,0,0,0,0,0,0,0
LAB North,Puerto Rico,2025,Energy Drinks,AMP,Pull-Non-Working,All Other Non-Working,League/property- rights fee/options,0,0,0,0,0,0,0
LAB North,Puerto Rico,2025,Energy Drinks,AMP,Pull-Non-Working,All Other Non-Working,Market Research,0,0,0,0,0,0,0
LAB North,Puerto Rico,2025,Energy Drinks,AMP,Pull-Non-Working,All Other Non-Working,Non-allocated NW,0,0,0,0,0,0,0
LAB North,Puerto Rico,2025,Energy Drinks,AMP,Pull-Non-Working,All Other Non-Working,Other Non Working-non itemised talent,0,0,0,0,0,0,0
LAB North,Puerto Rico,2025,Energy Drinks,AMP,Pull-Non-Working,All Other Non-Working,PR out of pocket administrative,0,0,0,0,0,0,0
LAB North,Puerto Rico,2025,Energy Drinks,AMP,Pull-Non-Working,Innovation and Insight,Innovations,0,0,0,0,0,0,0
LAB North,Puerto Rico,2025,Energy Drinks,AMP,Pull-Non-Working,Innovation and Insight,Market Research,0,0,0,0,0,0,0
LAB North,Puerto Rico,2025,Energy Drinks,AMP,Pull-Non-Working,Package Design,Package design,0,0,0,0,0,0,0
LAB North,Puerto Rico,2025,Energy Drinks,AMP,Pull-Non-Working,Package Design,Package development,0,0,0,0,0,0,0
LAB North,Puerto Rico,2025,Energy Drinks,AMP,STB - Push,Capability Building/Other,Capability Building Other,0,0,0,0,0,0,0
LAB North,Puerto Rico,2025,Energy Drinks,AMP,STB - Push,Other Investments,CDA's,0,0,0,0,0,0,0
LAB North,Puerto Rico,2025,Energy Drinks,AMP,STB - Push,Other Investments,Capital (Coolers),0,0,0,0,0,0,0
LAB North,Puerto Rico,2025,Energy Drinks,AMP,STB - Push,Other Investments,Price Support,50,7972,3986,3986,7972,3986,3986
LAB North,Puerto Rico,2025,Energy Drinks,AMP,STB - Push,Other Investments,Vending / Racks,0,0,0,0,0,0,0
LAB North,Puerto Rico,2025,Energy Drinks,AMP,STB - Push,Other Trade,Frozen Funds,0,0,0,0,0,0,0
LAB North,Puerto Rico,2025,Energy Drinks,AMP,STB - Push,Other Trade,Other Trade,0,0,0,0,0,0,0
LAB North,Puerto Rico,2025,Energy Drinks,AMP,STB - Push,Trade Equipment,Coolers - New,0,0,0,0,0,0,0
LAB North,Puerto Rico,2025,Energy Drinks,AMP,STB - Push,Trade Equipment,Coolers - Refurbished,0,0,0,0,0,0,0
LAB North,Puerto Rico,2025,Energy Drinks,AMP,STB - Push,Trade Equipment,Post Mix / Pre Mix Equip.,0,0,0,0,0,0,0
LAB North,Puerto Rico,2025,Energy Drinks,AMP,STB - Push,Trade Equipment,Vending / Racks,0,0,0,0,0,0,0
LAB North,Puerto Rico,2025,Energy Drinks,AMP,STB - Push,Trade Programs,Distribution Incentives,0,0,0,0,0,0,0
LAB North,Puerto Rico,2025,Energy Drinks,AMP,STB - Push,Trade Programs,Innovation Investments,0,0,0,0,0,0,0
LAB North,Puerto Rico,2025,Energy Drinks,AMP,STB - Push,Trade Programs,Sales Incentives,50,30932,15466,15466,30932,15466,15466
LAB North,Puerto Rico,2025,Energy Drinks,AMP,STB - Push,Trade Programs,Space Investments,0,0,0,0,0,0,0
LAB North,Puerto Rico,2025,Energy Drinks,AMP,Pull-Working,All Other Working,Other Working - PR execution,50,6069,3034,3035,6069,3034,3035
LAB North,Puerto Rico,2025,Energy Drinks,AMP,Pull-Working,All Other Working,Other Working - activation,0,0,0,0,0,0,0
LAB North,Puerto Rico,2025,Energy Drinks,AMP,Pull-Working,All Other Working,Other Working - non allocated working,0,0,0,0,0,0,0
LAB North,Puerto Rico,2025,Energy Drinks,AMP,Pull-Working,Consumer Promotions,Consumer Promotions Execution,0,0,0,0,0,0,0
LAB North,Puerto Rico,2025,Energy Drinks,AMP,Pull-Working,Consumer Promotions,Coupons,0,0,0,0,0,0,0
LAB North,Puerto Rico,2025,Energy Drinks,AMP,Pull-Working,Consumer Promotions,Other,0,0,0,0,0,0,0
LAB North,Puerto Rico,2025,Energy Drinks,AMP,Pull-Working,Consumer Promotions,Premiums,50,2944,1472,1472,2944,1472,1472
LAB North,Puerto Rico,2025,Energy Drinks,AMP,Pull-Working,In Store & POS Execution,In-Store & POS Execution,50,4079,2039,2040,4079,2039,2040
LAB North,Puerto Rico,2025,Energy Drinks,AMP,Pull-Working,Media Placements,Cinema,0,0,0,0,0,0,0
LAB North,Puerto Rico,2025,Energy Drinks,AMP,Pull-Working,Media Placements,Digital,50,64546,32273,32273,64546,32273,32273
LAB North,Puerto Rico,2025,Energy Drinks,AMP,Pull-Working,Media Placements,OOH - Out Of Home,50,29999,14999,15000,29999,14999,15000
LAB North,Puerto Rico,2025,Energy Drinks,AMP,Pull-Working,Media Placements,Other,0,0,0,0,0,0,0
LAB North,Puerto Rico,2025,Energy Drinks,AMP,Pull-Working,Media Placements,Print,0,0,0,0,0,0,0
LAB North,Puerto Rico,2025,Energy Drinks,AMP,Pull-Working,Media Placements,Radio,50,4606,2303,2303,4606,2303,2303
LAB North,Puerto Rico,2025,Energy Drinks,AMP,Pull-Working,Media Placements,TV,50,9272,4636,4636,9272,4636,4636
LAB North,Puerto Rico,2025,Energy Drinks,AMP,Pull-Working,Sampling,Product Samples,0,0,0,0,0,0,0
LAB North,Puerto Rico,2025,Energy Drinks,AMP,Pull-Working,Sampling,Sampling Execution,0,0,0,0,0,0,0
LAB North,Puerto Rico,2025,Energy Drinks,AMP,Pull-Working,Sponsorships,Sponsorships-in game/ in show,50,2268,1134,1134,2268,1134,1134
LAB North,Puerto Rico,2025,Energy Drinks,AMP,Pull-Working,Sponsorships,Sports-athlete/team contracts,0,0,0,0,0,0,0
LAB North,Puerto Rico,2025,Energy Drinks,AMP,Pull-Working,Sponsorships,Sports-on field or in show props,0,0,0,0,0,0,0
LAB North,Puerto Rico,2025,Energy Drinks,AMP,Pull-Working,Sponsorships,Sports-stadium contracts,0,0,0,0,0,0,0
LAB North,Puerto Rico,2025,Energy Drinks,Adrenaline,Pull-Non-Working,Ad Production,Digital Ad Production,0,0,0,0,0,0,0
LAB North,Puerto Rico,2025,Energy Drinks,Adrenaline,Pull-Non-Working,Ad Production,"TV, Print, Radio, OOH, Production",0,0,0,0,0,0,0
LAB North,Puerto Rico,2025,Energy Drinks,Adrenaline,Pull-Non-Working,Agency Fees,Creative Agency Fees,0,0,0,0,0,0,0
LAB North,Puerto Rico,2025,Energy Drinks,Adrenaline,Pull-Non-Working,Agency Fees,In Store & POS Design / Development,0,0,0,0,0,0,0
LAB North,Puerto Rico,2025,Energy Drinks,Adrenaline,Pull-Non-Working,Agency Fees,Media Agency Fees,0,0,0,0,0,0,0
LAB North,Puerto Rico,2025,Energy Drinks,Adrenaline,Pull-Non-Working,Agency Fees,Other,0,0,0,0,0,0,0
LAB North,Puerto Rico,2025,Energy Drinks,Adrenaline,Pull-Non-Working,Agency Fees,Social Media / Influence Marketing,0,0,0,0,0,0,0
LAB North,Puerto Rico,2025,Energy Drinks,Adrenaline,Pull-Non-Working,All Other Non-Working,Administrative fees,0,0,0,0,0,0,0
LAB North,Puerto Rico,2025,Energy Drinks,Adrenaline,Pull-Non-Working,All Other Non-Working,Agency out of pocket,0,0,0,0,0,0,0
LAB North,Puerto Rico,2025,Energy Drinks,Adrenaline,Pull-Non-Working,All Other Non-Working,CP out of pocket admin,0,0,0,0,0,0,0
LAB North,Puerto Rico,2025,Energy Drinks,Adrenaline,Pull-Non-Working,All Other Non-Working,Grassroots/experiential out of pocket,0,0,0,0,0,0,0
LAB North,Puerto Rico,2025,Energy Drinks,Adrenaline,Pull-Non-Working,All Other Non-Working,League/property- rights fee/options,0,0,0,0,0,0,0
LAB North,Puerto Rico,2025,Energy Drinks,Adrenaline,Pull-Non-Working,All Other Non-Working,Market Research,0,0,0,0,0,0,0
LAB North,Puerto Rico,2025,Energy Drinks,Adrenaline,Pull-Non-Working,All Other Non-Working,Non-allocated NW,0,0,0,0,0,0,0
LAB North,Puerto Rico,2025,Energy Drinks,Adrenaline,Pull-Non-Working,All Other Non-Working,Other Non Working-non itemised talent,0,0,0,0,0,0,0
LAB North,Puerto Rico,2025,Energy Drinks,Adrenaline,Pull-Non-Working,All Other Non-Working,PR out of pocket administrative,0,0,0,0,0,0,0
LAB North,Puerto Rico,2025,Energy Drinks,Adrenaline,Pull-Non-Working,Innovation and Insight,Innovations,0,0,0,0,0,0,0
LAB North,Puerto Rico,2025,Energy Drinks,Adrenaline,Pull-Non-Working,Innovation and Insight,Market Research,0,0,0,0,0,0,0
LAB North,Puerto Rico,2025,Energy Drinks,Adrenaline,Pull-Non-Working,Package Design,Package design,0,0,0,0,0,0,0
LAB North,Puerto Rico,2025,Energy Drinks,Adrenaline,Pull-Non-Working,Package Design,Package development,0,0,0,0,0,0,0
LAB North,Puerto Rico,2025,Energy Drinks,Adrenaline,STB - Push,Capability Building/Other,Capability Building Other,0,0,0,0,0,0,0
LAB North,Puerto Rico,2025,Energy Drinks,Adrenaline,STB - Push,Other Investments,CDA's,0,0,0,0,0,0,0
LAB North,Puerto Rico,2025,Energy Drinks,Adrenaline,STB - Push,Other Investments,Capital (Coolers),0,0,0,0,0,0,0
LAB North,Puerto Rico,2025,Energy Drinks,Adrenaline,STB - Push,Other Investments,Price Support,50,4358,2179,2179,4358,2179,2179
LAB North,Puerto Rico,2025,Energy Drinks,Adrenaline,STB - Push,Other Investments,Vending / Racks,0,0,0,0,0,0,0
LAB North,Puerto Rico,2025,Energy Drinks,Adrenaline,STB - Push,Other Trade,Frozen Funds,0,0,0,0,0,0,0
LAB North,Puerto Rico,2025,Energy Drinks,Adrenaline,STB - Push,Other Trade,Other Trade,0,0,0,0,0,0,0
LAB North,Puerto Rico,2025,Energy Drinks,Adrenaline,STB - Push,Trade Equipment,Coolers - New,0,0,0,0,0,0,0
LAB North,Puerto Rico,2025,Energy Drinks,Adrenaline,STB - Push,Trade Equipment,Coolers - Refurbished,0,0,0,0,0,0,0
LAB North,Puerto Rico,2025,Energy Drinks,Adrenaline,STB - Push,Trade Equipment,Post Mix / Pre Mix Equip.,0,0,0,0,0,0,0
LAB North,Puerto Rico,2025,Energy Drinks,Adrenaline,STB - Push,Trade Equipment,Vending / Racks,0,0,0,0,0,0,0
LAB North,Puerto Rico,2025,Energy Drinks,Adrenaline,STB - Push,Trade Programs,Distribution Incentives,0,0,0,0,0,0,0
LAB North,Puerto Rico,2025,Energy Drinks,Adrenaline,STB - Push,Trade Programs,Innovation Investments,0,0,0,0,0,0,0
LAB North,Puerto Rico,2025,Energy Drinks,Adrenaline,STB - Push,Trade Programs,Sales Incentives,0,0,0,0,0,0,0
LAB North,Puerto Rico,2025,Energy Drinks,Adrenaline,STB - Push,Trade Programs,Space Investments,0,0,0,0,0,0,0
LAB North,Puerto Rico,2025,Energy Drinks,Adrenaline,Pull-Working,All Other Working,Other Working - PR execution,0,0,0,0,0,0,0
LAB North,Puerto Rico,2025,Energy Drinks,Adrenaline,Pull-Working,All Other Working,Other Working - activation,0,0,0,0,0,0,0
LAB North,Puerto Rico,2025,Energy Drinks,Adrenaline,Pull-Working,All Other Working,Other Working - non allocated working,0,0,0,0,0,0,0
LAB North,Puerto Rico,2025,Energy Drinks,Adrenaline,Pull-Working,Consumer Promotions,Consumer Promotions Execution,0,0,0,0,0,0,0
LAB North,Puerto Rico,2025,Energy Drinks,Adrenaline,Pull-Working,Consumer Promotions,Coupons,0,0,0,0,0,0,0
LAB North,Puerto Rico,2025,Energy Drinks,Adrenaline,Pull-Working,Consumer Promotions,Other,0,0,0,0,0,0,0
LAB North,Puerto Rico,2025,Energy Drinks,Adrenaline,Pull-Working,Consumer Promotions,Premiums,0,0,0,0,0,0,0
LAB North,Puerto Rico,2025,Energy Drinks,Adrenaline,Pull-Working,In Store & POS Execution,In-Store & POS Execution,50,3184,1592,1592,3184,1592,1592
LAB North,Puerto Rico,2025,Energy Drinks,Adrenaline,Pull-Working,Media Placements,Cinema,0,0,0,0,0,0,0
LAB North,Puerto Rico,2025,Energy Drinks,Adrenaline,Pull-Working,Media Placements,Digital,0,0,0,0,0,0,0
LAB North,Puerto Rico,2025,Energy Drinks,Adrenaline,Pull-Working,Media Placements,OOH - Out Of Home,0,0,0,0,0,0,0
LAB North,Puerto Rico,2025,Energy Drinks,Adrenaline,Pull-Working,Media Placements,Other,0,0,0,0,0,0,0
LAB North,Puerto Rico,2025,Energy Drinks,Adrenaline,Pull-Working,Media Placements,Print,0,0,0,0,0,0,0
LAB North,Puerto Rico,2025,Energy Drinks,Adrenaline,Pull-Working,Media Placements,Radio,0,0,0,0,0,0,0
LAB North,Puerto Rico,2025,Energy Drinks,Adrenaline,Pull-Working,Media Placements,TV,0,0,0,0,0,0,0
LAB North,Puerto Rico,2025,Energy Drinks,Adrenaline,Pull-Working,Sampling,Product Samples,0,0,0,0,0,0,0
LAB North,Puerto Rico,2025,Energy Drinks,Adrenaline,Pull-Working,Sampling,Sampling Execution,0,0,0,0,0,0,0
LAB North,Puerto Rico,2025,Energy Drinks,Adrenaline,Pull-Working,Sponsorships,Sponsorships-in game/ in show,0,0,0,0,0,0,0
LAB North,Puerto Rico,2025,Energy Drinks,Adrenaline,Pull-Working,Sponsorships,Sports-athlete/team contracts,0,0,0,0,0,0,0
LAB North,Puerto Rico,2025,Energy Drinks,Adrenaline,Pull-Working,Sponsorships,Sports-on field or in show props,0,0,0,0,0,0,0
LAB North,Puerto Rico,2025,Energy Drinks,Adrenaline,Pull-Working,Sponsorships,Sports-stadium contracts,0,0,0,0,0,0,0
LAB North,Puerto Rico,2025,Water,Be-Light,Pull-Non-Working,Ad Production,Digital Ad Production,0,0,0,0,0,0,0
LAB North,Puerto Rico,2025,Water,Be-Light,Pull-Non-Working,Ad Production,"TV, Print, Radio, OOH, Production",0,0,0,0,0,0,0
LAB North,Puerto Rico,2025,Water,Be-Light,Pull-Non-Working,Agency Fees,Creative Agency Fees,0,0,0,0,0,0,0
LAB North,Puerto Rico,2025,Water,Be-Light,Pull-Non-Working,Agency Fees,In Store & POS Design / Development,0,0,0,0,0,0,0
LAB North,Puerto Rico,2025,Water,Be-Light,Pull-Non-Working,Agency Fees,Media Agency Fees,0,0,0,0,0,0,0
LAB North,Puerto Rico,2025,Water,Be-Light,Pull-Non-Working,Agency Fees,Other,0,0,0,0,0,0,0
LAB North,Puerto Rico,2025,Water,Be-Light,Pull-Non-Working,Agency Fees,Social Media / Influence Marketing,0,0,0,0,0,0,0
LAB North,Puerto Rico,2025,Water,Be-Light,Pull-Non-Working,All Other Non-Working,Administrative fees,0,0,0,0,0,0,0
LAB North,Puerto Rico,2025,Water,Be-Light,Pull-Non-Working,All Other Non-Working,Agency out of pocket,0,0,0,0,0,0,0
LAB North,Puerto Rico,2025,Water,Be-Light,Pull-Non-Working,All Other Non-Working,CP out of pocket admin,0,0,0,0,0,0,0
LAB North,Puerto Rico,2025,Water,Be-Light,Pull-Non-Working,All Other Non-Working,Grassroots/experiential out of pocket,0,0,0,0,0,0,0
LAB North,Puerto Rico,2025,Water,Be-Light,Pull-Non-Working,All Other Non-Working,League/property- rights fee/options,0,0,0,0,0,0,0
LAB North,Puerto Rico,2025,Water,Be-Light,Pull-Non-Working,All Other Non-Working,Market Research,0,0,0,0,0,0,0
LAB North,Puerto Rico,2025,Water,Be-Light,Pull-Non-Working,All Other Non-Working,Non-allocated NW,0,0,0,0,0,0,0
LAB North,Puerto Rico,2025,Water,Be-Light,Pull-Non-Working,All Other Non-Working,Other Non Working-non itemised talent,0,0,0,0,0,0,0
LAB North,Puerto Rico,2025,Water,Be-Light,Pull-Non-Working,All Other Non-Working,PR out of pocket administrative,0,0,0,0,0,0,0
LAB North,Puerto Rico,2025,Water,Be-Light,Pull-Non-Working,Innovation and Insight,Innovations,0,0,0,0,0,0,0
LAB North,Puerto Rico,2025,Water,Be-Light,Pull-Non-Working,Innovation and Insight,Market Research,0,0,0,0,0,0,0
LAB North,Puerto Rico,2025,Water,Be-Light,Pull-Non-Working,Package Design,Package design,0,0,0,0,0,0,0
LAB North,Puerto Rico,2025,Water,Be-Light,Pull-Non-Working,Package Design,Package development,0,0,0,0,0,0,0
LAB North,Puerto Rico,2025,Water,Be-Light,STB - Push,Capability Building/Other,Capability Building Other,0,0,0,0,0,0,0
LAB North,Puerto Rico,2025,Water,Be-Light,STB - Push,Other Investments,CDA's,0,0,0,0,0,0,0
LAB North,Puerto Rico,2025,Water,Be-Light,STB - Push,Other Investments,Capital (Coolers),0,0,0,0,0,0,0
LAB North,Puerto Rico,2025,Water,Be-Light,STB - Push,Other Investments,Price Support,50,118,59,59,118,59,59
LAB North,Puerto Rico,2025,Water,Be-Light,STB - Push,Other Investments,Vending / Racks,0,0,0,0,0,0,0
LAB North,Puerto Rico,2025,Water,Be-Light,STB - Push,Other Trade,Frozen Funds,0,0,0,0,0,0,0
LAB North,Puerto Rico,2025,Water,Be-Light,STB - Push,Other Trade,Other Trade,0,0,0,0,0,0,0
LAB North,Puerto Rico,2025,Water,Be-Light,STB - Push,Trade Equipment,Coolers - New,0,0,0,0,0,0,0
LAB North,Puerto Rico,2025,Water,Be-Light,STB - Push,Trade Equipment,Coolers - Refurbished,0,0,0,0,0,0,0
LAB North,Puerto Rico,2025,Water,Be-Light,STB - Push,Trade Equipment,Post Mix / Pre Mix Equip.,0,0,0,0,0,0,0
LAB North,Puerto Rico,2025,Water,Be-Light,STB - Push,Trade Equipment,Vending / Racks,0,0,0,0,0,0,0
LAB North,Puerto Rico,2025,Water,Be-Light,STB - Push,Trade Programs,Distribution Incentives,0,0,0,0,0,0,0
LAB North,Puerto Rico,2025,Water,Be-Light,STB - Push,Trade Programs,Innovation Investments,0,0,0,0,0,0,0
LAB North,Puerto Rico,2025,Water,Be-Light,STB - Push,Trade Programs,Sales Incentives,0,0,0,0,0,0,0
LAB North,Puerto Rico,2025,Water,Be-Light,STB - Push,Trade Programs,Space Investments,0,0,0,0,0,0,0
LAB North,Puerto Rico,2025,Water,Be-Light,Pull-Working,All Other Working,Other Working - PR execution,0,0,0,0,0,0,0
LAB North,Puerto Rico,2025,Water,Be-Light,Pull-Working,All Other Working,Other Working - activation,0,0,0,0,0,0,0
LAB North,Puerto Rico,2025,Water,Be-Light,Pull-Working,All Other Working,Other Working - non allocated working,0,0,0,0,0,0,0
LAB North,Puerto Rico,2025,Water,Be-Light,Pull-Working,Consumer Promotions,Consumer Promotions Execution,0,0,0,0,0,0,0
LAB North,Puerto Rico,2025,Water,Be-Light,Pull-Working,Consumer Promotions,Coupons,0,0,0,0,0,0,0
LAB North,Puerto Rico,2025,Water,Be-Light,Pull-Working,Consumer Promotions,Other,0,0,0,0,0,0,0
LAB North,Puerto Rico,2025,Water,Be-Light,Pull-Working,Consumer Promotions,Premiums,0,0,0,0,0,0,0
LAB North,Puerto Rico,2025,Water,Be-Light,Pull-Working,In Store & POS Execution,In-Store & POS Execution,0,0,0,0,0,0,0
LAB North,Puerto Rico,2025,Water,Be-Light,Pull-Working,Media Placements,Cinema,0,0,0,0,0,0,0
LAB North,Puerto Rico,2025,Water,Be-Light,Pull-Working,Media Placements,Digital,0,0,0,0,0,0,0
LAB North,Puerto Rico,2025,Water,Be-Light,Pull-Working,Media Placements,OOH - Out Of Home,0,0,0,0,0,0,0
LAB North,Puerto Rico,2025,Water,Be-Light,Pull-Working,Media Placements,Other,0,0,0,0,0,0,0
LAB North,Puerto Rico,2025,Water,Be-Light,Pull-Working,Media Placements,Print,0,0,0,0,0,0,0
LAB North,Puerto Rico,2025,Water,Be-Light,Pull-Working,Media Placements,Radio,0,0,0,0,0,0,0
LAB North,Puerto Rico,2025,Water,Be-Light,Pull-Working,Media Placements,TV,0,0,0,0,0,0,0
LAB North,Puerto Rico,2025,Water,Be-Light,Pull-Working,Sampling,Product Samples,0,0,0,0,0,0,0
LAB North,Puerto Rico,2025,Water,Be-Light,Pull-Working,Sampling,Sampling Execution,0,0,0,0,0,0,0
LAB North,Puerto Rico,2025,Water,Be-Light,Pull-Working,Sponsorships,Sponsorships-in game/ in show,0,0,0,0,0,0,0
LAB North,Puerto Rico,2025,Water,Be-Light,Pull-Working,Sponsorships,Sports-athlete/team contracts,0,0,0,0,0,0,0
LAB North,Puerto Rico,2025,Water,Be-Light,Pull-Working,Sponsorships,Sports-on field or in show props,0,0,0,0,0,0,0
LAB North,Puerto Rico,2025,Water,Be-Light,Pull-Working,Sponsorships,Sports-stadium contracts,0,0,0,0,0,0,0
LAB North,Puerto Rico,2025,Sport Drinks,Gatorade,Pull-Non-Working,Ad Production,Digital Ad Production,0,0,0,0,0,0,0
LAB North,Puerto Rico,2025,Sport Drinks,Gatorade,Pull-Non-Working,Ad Production,"TV, Print, Radio, OOH, Production",50,81858,40929,40929,81858,40929,40929
LAB North,Puerto Rico,2025,Sport Drinks,Gatorade,Pull-Non-Working,Agency Fees,Creative Agency Fees,0,0,0,0,0,0,0
LAB North,Puerto Rico,2025,Sport Drinks,Gatorade,Pull-Non-Working,Agency Fees,In Store & POS Design / Development,0,0,0,0,0,0,0
LAB North,Puerto Rico,2025,Sport Drinks,Gatorade,Pull-Non-Working,Agency Fees,Media Agency Fees,0,0,0,0,0,0,0
LAB North,Puerto Rico,2025,Sport Drinks,Gatorade,Pull-Non-Working,Agency Fees,Other,0,0,0,0,0,0,0
LAB North,Puerto Rico,2025,Sport Drinks,Gatorade,Pull-Non-Working,Agency Fees,Social Media / Influence Marketing,0,0,0,0,0,0,0
LAB North,Puerto Rico,2025,Sport Drinks,Gatorade,Pull-Non-Working,All Other Non-Working,Administrative fees,0,0,0,0,0,0,0
LAB North,Puerto Rico,2025,Sport Drinks,Gatorade,Pull-Non-Working,All Other Non-Working,Agency out of pocket,0,0,0,0,0,0,0
LAB North,Puerto Rico,2025,Sport Drinks,Gatorade,Pull-Non-Working,All Other Non-Working,CP out of pocket admin,0,0,0,0,0,0,0
LAB North,Puerto Rico,2025,Sport Drinks,Gatorade,Pull-Non-Working,All Other Non-Working,Grassroots/experiential out of pocket,0,0,0,0,0,0,0
LAB North,Puerto Rico,2025,Sport Drinks,Gatorade,Pull-Non-Working,All Other Non-Working,League/property- rights fee/options,0,0,0,0,0,0,0
LAB North,Puerto Rico,2025,Sport Drinks,Gatorade,Pull-Non-Working,All Other Non-Working,Market Research,0,0,0,0,0,0,0
LAB North,Puerto Rico,2025,Sport Drinks,Gatorade,Pull-Non-Working,All Other Non-Working,Non-allocated NW,0,0,0,0,0,0,0
LAB North,Puerto Rico,2025,Sport Drinks,Gatorade,Pull-Non-Working,All Other Non-Working,Other Non Working-non itemised talent,0,0,0,0,0,0,0
LAB North,Puerto Rico,2025,Sport Drinks,Gatorade,Pull-Non-Working,All Other Non-Working,PR out of pocket administrative,0,0,0,0,0,0,0
LAB North,Puerto Rico,2025,Sport Drinks,Gatorade,Pull-Non-Working,Innovation and Insight,Innovations,0,0,0,0,0,0,0
LAB North,Puerto Rico,2025,Sport Drinks,Gatorade,Pull-Non-Working,Innovation and Insight,Market Research,0,0,0,0,0,0,0
LAB North,Puerto Rico,2025,Sport Drinks,Gatorade,Pull-Non-Working,Package Design,Package design,0,0,0,0,0,0,0
LAB North,Puerto Rico,2025,Sport Drinks,Gatorade,Pull-Non-Working,Package Design,Package development,0,0,0,0,0,0,0
LAB North,Puerto Rico,2025,Sport Drinks,Gatorade,STB - Push,Capability Building/Other,Capability Building Other,0,0,0,0,0,0,0
LAB North,Puerto Rico,2025,Sport Drinks,Gatorade,STB - Push,Other Investments,CDA's,0,0,0,0,0,0,0
LAB North,Puerto Rico,2025,Sport Drinks,Gatorade,STB - Push,Other Investments,Capital (Coolers),0,0,0,0,0,0,0
LAB North,Puerto Rico,2025,Sport Drinks,Gatorade,STB - Push,Other Investments,Price Support,50,1450523,725261,725262,1450523,725261,725262
LAB North,Puerto Rico,2025,Sport Drinks,Gatorade,STB - Push,Other Investments,Vending / Racks,0,0,0,0,0,0,0
LAB North,Puerto Rico,2025,Sport Drinks,Gatorade,STB - Push,Other Trade,Frozen Funds,0,0,0,0,0,0,0
LAB North,Puerto Rico,2025,Sport Drinks,Gatorade,STB - Push,Other Trade,Other Trade,0,0,0,0,0,0,0
LAB North,Puerto Rico,2025,Sport Drinks,Gatorade,STB - Push,Trade Equipment,Coolers - New,0,0,0,0,0,0,0
LAB North,Puerto Rico,2025,Sport Drinks,Gatorade,STB - Push,Trade Equipment,Coolers - Refurbished,0,0,0,0,0,0,0
LAB North,Puerto Rico,2025,Sport Drinks,Gatorade,STB - Push,Trade Equipment,Post Mix / Pre Mix Equip.,0,0,0,0,0,0,0
LAB North,Puerto Rico,2025,Sport Drinks,Gatorade,STB - Push,Trade Equipment,Vending / Racks,0,0,0,0,0,0,0
LAB North,Puerto Rico,2025,Sport Drinks,Gatorade,STB - Push,Trade Programs,Distribution Incentives,0,0,0,0,0,0,0
LAB North,Puerto Rico,2025,Sport Drinks,Gatorade,STB - Push,Trade Programs,Innovation Investments,0,0,0,0,0,0,0
LAB North,Puerto Rico,2025,Sport Drinks,Gatorade,STB - Push,Trade Programs,Sales Incentives,50,79093,39546,39547,79093,39546,39547
LAB North,Puerto Rico,2025,Sport Drinks,Gatorade,STB - Push,Trade Programs,Space Investments,0,0,0,0,0,0,0
LAB North,Puerto Rico,2025,Sport Drinks,Gatorade,Pull-Working,All Other Working,Other Working - PR execution,50,15849,7924,7925,15849,7924,7925
LAB North,Puerto Rico,2025,Sport Drinks,Gatorade,Pull-Working,All Other Working,Other Working - activation,0,0,0,0,0,0,0
LAB North,Puerto Rico,2025,Sport Drinks,Gatorade,Pull-Working,All Other Working,Other Working - non allocated working,0,0,0,0,0,0,0
LAB North,Puerto Rico,2025,Sport Drinks,Gatorade,Pull-Working,Consumer Promotions,Consumer Promotions Execution,0,0,0,0,0,0,0
LAB North,Puerto Rico,2025,Sport Drinks,Gatorade,Pull-Working,Consumer Promotions,Coupons,0,0,0,0,0,0,0
LAB North,Puerto Rico,2025,Sport Drinks,Gatorade,Pull-Working,Consumer Promotions,Other,0,0,0,0,0,0,0
LAB North,Puerto Rico,2025,Sport Drinks,Gatorade,Pull-Working,Consumer Promotions,Premiums,50,91777,45888,45889,91777,45888,45889
LAB North,Puerto Rico,2025,Sport Drinks,Gatorade,Pull-Working,In Store & POS Execution,In-Store & POS Execution,50,93868,46934,46934,93868,46934,46934
LAB North,Puerto Rico,2025,Sport Drinks,Gatorade,Pull-Working,Media Placements,Cinema,0,0,0,0,0,0,0
LAB North,Puerto Rico,2025,Sport Drinks,Gatorade,Pull-Working,Media Placements,Digital,50,140499,70249,70250,140499,70249,70250
LAB North,Puerto Rico,2025,Sport Drinks,Gatorade,Pull-Working,Media Placements,OOH - Out Of Home,50,142553,71276,71277,142553,71276,71277
LAB North,Puerto Rico,2025,Sport Drinks,Gatorade,Pull-Working,Media Placements,Other,0,0,0,0,0,0,0
LAB North,Puerto Rico,2025,Sport Drinks,Gatorade,Pull-Working,Media Placements,Print,0,0,0,0,0,0,0
LAB North,Puerto Rico,2025,Sport Drinks,Gatorade,Pull-Working,Media Placements,Radio,50,10000,5000,5000,10000,5000,5000
LAB North,Puerto Rico,2025,Sport Drinks,Gatorade,Pull-Working,Media Placements,TV,50,30800,15400,15400,30800,15400,15400
LAB North,Puerto Rico,2025,Sport Drinks,Gatorade,Pull-Working,Sampling,Product Samples,0,0,0,0,0,0,0
LAB North,Puerto Rico,2025,Sport Drinks,Gatorade,Pull-Working,Sampling,Sampling Execution,0,0,0,0,0,0,0
LAB North,Puerto Rico,2025,Sport Drinks,Gatorade,Pull-Working,Sponsorships,Sponsorships-in game/ in show,50,116467,58233,58234,116467,58233,58234
LAB North,Puerto Rico,2025,Sport Drinks,Gatorade,Pull-Working,Sponsorships,Sports-athlete/team contracts,50,123651,61825,61826,123651,61825,61826
LAB North,Puerto Rico,2025,Sport Drinks,Gatorade,Pull-Working,Sponsorships,Sports-on field or in show props,0,0,0,0,0,0,0
LAB North,Puerto Rico,2025,Sport Drinks,Gatorade,Pull-Working,Sponsorships,Sports-stadium contracts,0,0,0,0,0,0,0
LAB North,Puerto Rico,2025,RTD Tea,Lipton,Pull-Non-Working,Ad Production,Digital Ad Production,0,0,0,0,0,0,0
LAB North,Puerto Rico,2025,RTD Tea,Lipton,Pull-Non-Working,Ad Production,"TV, Print, Radio, OOH, Production",50,23828,11914,11914,23828,11914,11914
LAB North,Puerto Rico,2025,RTD Tea,Lipton,Pull-Non-Working,Agency Fees,Creative Agency Fees,0,0,0,0,0,0,0
LAB North,Puerto Rico,2025,RTD Tea,Lipton,Pull-Non-Working,Agency Fees,In Store & POS Design / Development,0,0,0,0,0,0,0
LAB North,Puerto Rico,2025,RTD Tea,Lipton,Pull-Non-Working,Agency Fees,Media Agency Fees,0,0,0,0,0,0,0
LAB North,Puerto Rico,2025,RTD Tea,Lipton,Pull-Non-Working,Agency Fees,Other,0,0,0,0,0,0,0
LAB North,Puerto Rico,2025,RTD Tea,Lipton,Pull-Non-Working,Agency Fees,Social Media / Influence Marketing,0,0,0,0,0,0,0
LAB North,Puerto Rico,2025,RTD Tea,Lipton,Pull-Non-Working,All Other Non-Working,Administrative fees,0,0,0,0,0,0,0
LAB North,Puerto Rico,2025,RTD Tea,Lipton,Pull-Non-Working,All Other Non-Working,Agency out of pocket,0,0,0,0,0,0,0
LAB North,Puerto Rico,2025,RTD Tea,Lipton,Pull-Non-Working,All Other Non-Working,CP out of pocket admin,0,0,0,0,0,0,0
LAB North,Puerto Rico,2025,RTD Tea,Lipton,Pull-Non-Working,All Other Non-Working,Grassroots/experiential out of pocket,0,0,0,0,0,0,0
LAB North,Puerto Rico,2025,RTD Tea,Lipton,Pull-Non-Working,All Other Non-Working,League/property- rights fee/options,0,0,0,0,0,0,0
LAB North,Puerto Rico,2025,RTD Tea,Lipton,Pull-Non-Working,All Other Non-Working,Market Research,0,0,0,0,0,0,0
LAB North,Puerto Rico,2025,RTD Tea,Lipton,Pull-Non-Working,All Other Non-Working,Non-allocated NW,0,0,0,0,0,0,0
LAB North,Puerto Rico,2025,RTD Tea,Lipton,Pull-Non-Working,All Other Non-Working,Other Non Working-non itemised talent,0,0,0,0,0,0,0
LAB North,Puerto Rico,2025,RTD Tea,Lipton,Pull-Non-Working,All Other Non-Working,PR out of pocket administrative,0,0,0,0,0,0,0
LAB North,Puerto Rico,2025,RTD Tea,Lipton,Pull-Non-Working,Innovation and Insight,Innovations,0,0,0,0,0,0,0
LAB North,Puerto Rico,2025,RTD Tea,Lipton,Pull-Non-Working,Innovation and Insight,Market Research,0,0,0,0,0,0,0
LAB North,Puerto Rico,2025,RTD Tea,Lipton,Pull-Non-Working,Package Design,Package design,0,0,0,0,0,0,0
LAB North,Puerto Rico,2025,RTD Tea,Lipton,Pull-Non-Working,Package Design,Package development,0,0,0,0,0,0,0
LAB North,Puerto Rico,2025,RTD Tea,Lipton,STB - Push,Capability Building/Other,Capability Building Other,0,0,0,0,0,0,0
LAB North,Puerto Rico,2025,RTD Tea,Lipton,STB - Push,Other Investments,CDA's,50,718319,359159,359160,718319,359159,359160
LAB North,Puerto Rico,2025,RTD Tea,Lipton,STB - Push,Other Investments,Capital (Coolers),0,0,0,0,0,0,0
LAB North,Puerto Rico,2025,RTD Tea,Lipton,STB - Push,Other Investments,Price Support,50,300442,150221,150221,300442,150221,150221
LAB North,Puerto Rico,2025,RTD Tea,Lipton,STB - Push,Other Investments,Vending / Racks,0,0,0,0,0,0,0
LAB North,Puerto Rico,2025,RTD Tea,Lipton,STB - Push,Other Trade,Frozen Funds,0,0,0,0,0,0,0
LAB North,Puerto Rico,2025,RTD Tea,Lipton,STB - Push,Other Trade,Other Trade,0,0,0,0,0,0,0
LAB North,Puerto Rico,2025,RTD Tea,Lipton,STB - Push,Trade Equipment,Coolers - New,0,0,0,0,0,0,0
LAB North,Puerto Rico,2025,RTD Tea,Lipton,STB - Push,Trade Equipment,Coolers - Refurbished,0,0,0,0,0,0,0
LAB North,Puerto Rico,2025,RTD Tea,Lipton,STB - Push,Trade Equipment,Post Mix / Pre Mix Equip.,50,481111,240555,240556,481111,240555,240556
LAB North,Puerto Rico,2025,RTD Tea,Lipton,STB - Push,Trade Equipment,Vending / Racks,0,0,0,0,0,0,0
LAB North,Puerto Rico,2025,RTD Tea,Lipton,STB - Push,Trade Programs,Distribution Incentives,0,0,0,0,0,0,0
LAB North,Puerto Rico,2025,RTD Tea,Lipton,STB - Push,Trade Programs,Innovation Investments,0,0,0,0,0,0,0
LAB North,Puerto Rico,2025,RTD Tea,Lipton,STB - Push,Trade Programs,Sales Incentives,50,1437,718,719,1437,718,719
LAB North,Puerto Rico,2025,RTD Tea,Lipton,STB - Push,Trade Programs,Space Investments,0,0,0,0,0,0,0
LAB North,Puerto Rico,2025,RTD Tea,Lipton,Pull-Working,All Other Working,Other Working - PR execution,50,5850,2925,2925,5850,2925,2925
LAB North,Puerto Rico,2025,RTD Tea,Lipton,Pull-Working,All Other Working,Other Working - activation,0,0,0,0,0,0,0
LAB North,Puerto Rico,2025,RTD Tea,Lipton,Pull-Working,All Other Working,Other Working - non allocated working,0,0,0,0,0,0,0
LAB North,Puerto Rico,2025,RTD Tea,Lipton,Pull-Working,Consumer Promotions,Consumer Promotions Execution,0,0,0,0,0,0,0
LAB North,Puerto Rico,2025,RTD Tea,Lipton,Pull-Working,Consumer Promotions,Coupons,0,0,0,0,0,0,0
LAB North,Puerto Rico,2025,RTD Tea,Lipton,Pull-Working,Consumer Promotions,Other,0,0,0,0,0,0,0
LAB North,Puerto Rico,2025,RTD Tea,Lipton,Pull-Working,Consumer Promotions,Premiums,50,27175,13587,13588,27175,13587,13588
LAB North,Puerto Rico,2025,RTD Tea,Lipton,Pull-Working,In Store & POS Execution,In-Store & POS Execution,50,21499,10749,10750,21499,10749,10750
LAB North,Puerto Rico,2025,RTD Tea,Lipton,Pull-Working,Media Placements,Cinema,0,0,0,0,0,0,0
LAB North,Puerto Rico,2025,RTD Tea,Lipton,Pull-Working,Media Placements,Digital,50,122375,61187,61188,122375,61187,61188
LAB North,Puerto Rico,2025,RTD Tea,Lipton,Pull-Working,Media Placements,OOH - Out Of Home,50,74999,37499,37500,74999,37499,37500
LAB North,Puerto Rico,2025,RTD Tea,Lipton,Pull-Working,Media Placements,Other,0,0,0,0,0,0,0
LAB North,Puerto Rico,2025,RTD Tea,Lipton,Pull-Working,Media Placements,Print,0,0,0,0,0,0,0
LAB North,Puerto Rico,2025,RTD Tea,Lipton,Pull-Working,Media Placements,Radio,0,0,0,0,0,0,0
LAB North,Puerto Rico,2025,RTD Tea,Lipton,Pull-Working,Media Placements,TV,0,0,0,0,0,0,0
LAB North,Puerto Rico,2025,RTD Tea,Lipton,Pull-Working,Sampling,Product Samples,0,0,0,0,0,0,0
LAB North,Puerto Rico,2025,RTD Tea,Lipton,Pull-Working,Sampling,Sampling Execution,0,0,0,0,0,0,0
LAB North,Puerto Rico,2025,RTD Tea,Lipton,Pull-Working,Sponsorships,Sponsorships-in game/ in show,50,38868,19434,19434,38868,19434,19434
LAB North,Puerto Rico,2025,RTD Tea,Lipton,Pull-Working,Sponsorships,Sports-athlete/team contracts,0,0,0,0,0,0,0
LAB North,Puerto Rico,2025,RTD Tea,Lipton,Pull-Working,Sponsorships,Sports-on field or in show props,0,0,0,0,0,0,0
LAB North,Puerto Rico,2025,RTD Tea,Lipton,Pull-Working,Sponsorships,Sports-stadium contracts,0,0,0,0,0,0,0
LAB North,Puerto Rico,2025,CSD,Pepsi,Pull-Non-Working,Ad Production,Digital Ad Production,0,0,0,0,0,0,0
LAB North,Puerto Rico,2025,CSD,Pepsi,Pull-Non-Working,Ad Production,"TV, Print, Radio, OOH, Production",50,106195,53097,53098,106195,53097,53098
LAB North,Puerto Rico,2025,CSD,Pepsi,Pull-Non-Working,Agency Fees,Creative Agency Fees,0,0,0,0,0,0,0
LAB North,Puerto Rico,2025,CSD,Pepsi,Pull-Non-Working,Agency Fees,In Store & POS Design / Development,0,0,0,0,0,0,0
LAB North,Puerto Rico,2025,CSD,Pepsi,Pull-Non-Working,Agency Fees,Media Agency Fees,0,0,0,0,0,0,0
LAB North,Puerto Rico,2025,CSD,Pepsi,Pull-Non-Working,Agency Fees,Other,0,0,0,0,0,0,0
LAB North,Puerto Rico,2025,CSD,Pepsi,Pull-Non-Working,Agency Fees,Social Media / Influence Marketing,0,0,0,0,0,0,0
LAB North,Puerto Rico,2025,CSD,Pepsi,Pull-Non-Working,All Other Non-Working,Administrative fees,0,0,0,0,0,0,0
LAB North,Puerto Rico,2025,CSD,Pepsi,Pull-Non-Working,All Other Non-Working,Agency out of pocket,0,0,0,0,0,0,0
LAB North,Puerto Rico,2025,CSD,Pepsi,Pull-Non-Working,All Other Non-Working,CP out of pocket admin,0,0,0,0,0,0,0
LAB North,Puerto Rico,2025,CSD,Pepsi,Pull-Non-Working,All Other Non-Working,Grassroots/experiential out of pocket,0,0,0,0,0,0,0
LAB North,Puerto Rico,2025,CSD,Pepsi,Pull-Non-Working,All Other Non-Working,League/property- rights fee/options,0,0,0,0,0,0,0
LAB North,Puerto Rico,2025,CSD,Pepsi,Pull-Non-Working,All Other Non-Working,Market Research,0,0,0,0,0,0,0
LAB North,Puerto Rico,2025,CSD,Pepsi,Pull-Non-Working,All Other Non-Working,Non-allocated NW,0,0,0,0,0,0,0
LAB North,Puerto Rico,2025,CSD,Pepsi,Pull-Non-Working,All Other Non-Working,Other Non Working-non itemised talent,0,0,0,0,0,0,0
LAB North,Puerto Rico,2025,CSD,Pepsi,Pull-Non-Working,All Other Non-Working,PR out of pocket administrative,0,0,0,0,0,0,0
LAB North,Puerto Rico,2025,CSD,Pepsi,Pull-Non-Working,Innovation and Insight,Innovations,0,0,0,0,0,0,0
LAB North,Puerto Rico,2025,CSD,Pepsi,Pull-Non-Working,Innovation and Insight,Market Research,50,200741,100370,100371,200741,100370,100371
LAB North,Puerto Rico,2025,CSD,Pepsi,Pull-Non-Working,Package Design,Package design,0,0,0,0,0,0,0
LAB North,Puerto Rico,2025,CSD,Pepsi,Pull-Non-Working,Package Design,Package development,0,0,0,0,0,0,0
LAB North,Puerto Rico,2025,CSD,Pepsi,STB - Push,Capability Building/Other,Capability Building Other,0,0,0,0,0,0,0
LAB North,Puerto Rico,2025,CSD,Pepsi,STB - Push,Other Investments,CDA's,50,737976,368988,368988,737976,368988,368988
LAB North,Puerto Rico,2025,CSD,Pepsi,STB - Push,Other Investments,Capital (Coolers),0,0,0,0,0,0,0
LAB North,Puerto Rico,2025,CSD,Pepsi,STB - Push,Other Investments,Price Support,50,2132842,1066421,1066421,2132842,1066421,1066421
LAB North,Puerto Rico,2025,CSD,Pepsi,STB - Push,Other Investments,Vending / Racks,0,0,0,0,0,0,0
LAB North,Puerto Rico,2025,CSD,Pepsi,STB - Push,Other Trade,Frozen Funds,0,0,0,0,0,0,0
LAB North,Puerto Rico,2025,CSD,Pepsi,STB - Push,Other Trade,Other Trade,50,194969,97484,97485,194969,97484,97485
LAB North,Puerto Rico,2025,CSD,Pepsi,STB - Push,Trade Equipment,Coolers - New,0,0,0,0,0,0,0
LAB North,Puerto Rico,2025,CSD,Pepsi,STB - Push,Trade Equipment,Coolers - Refurbished,0,0,0,0,0,0,0
LAB North,Puerto Rico,2025,CSD,Pepsi,STB - Push,Trade Equipment,Post Mix / Pre Mix Equip.,50,481111,240555,240556,481111,240555,240556
LAB North,Puerto Rico,2025,CSD,Pepsi,STB - Push,Trade Equipment,Vending / Racks,0,0,0,0,0,0,0
LAB North,Puerto Rico,2025,CSD,Pepsi,STB - Push,Trade Programs,Distribution Incentives,0,0,0,0,0,0,0
LAB North,Puerto Rico,2025,CSD,Pepsi,STB - Push,Trade Programs,Innovation Investments,0,0,0,0,0,0,0
LAB North,Puerto Rico,2025,CSD,Pepsi,STB - Push,Trade Programs,Sales Incentives,50,367316,183658,183658,367316,183658,183658
LAB North,Puerto Rico,2025,CSD,Pepsi,STB - Push,Trade Programs,Space Investments,0,0,0,0,0,0,0
LAB North,Puerto Rico,2025,CSD,Pepsi,Pull-Working,All Other Working,Other Working - PR execution,50,6069,3034,3035,6069,3034,3035
LAB North,Puerto Rico,2025,CSD,Pepsi,Pull-Working,All Other Working,Other Working - activation,0,0,0,0,0,0,0
LAB North,Puerto Rico,2025,CSD,Pepsi,Pull-Working,All Other Working,Other Working - non allocated working,0,0,0,0,0,0,0
LAB North,Puerto Rico,2025,CSD,Pepsi,Pull-Working,Consumer Promotions,Consumer Promotions Execution,50,43099,21549,21550,43099,21549,21550
LAB North,Puerto Rico,2025,CSD,Pepsi,Pull-Working,Consumer Promotions,Coupons,0,0,0,0,0,0,0
LAB North,Puerto Rico,2025,CSD,Pepsi,Pull-Working,Consumer Promotions,Other,0,0,0,0,0,0,0
LAB North,Puerto Rico,2025,CSD,Pepsi,Pull-Working,Consumer Promotions,Premiums,50,108094,54047,54047,108094,54047,54047
LAB North,Puerto Rico,2025,CSD,Pepsi,Pull-Working,In Store & POS Execution,In-Store & POS Execution,50,473417,236708,236709,473417,236708,236709
LAB North,Puerto Rico,2025,CSD,Pepsi,Pull-Working,Media Placements,Cinema,0,0,0,0,0,0,0
LAB North,Puerto Rico,2025,CSD,Pepsi,Pull-Working,Media Placements,Digital,50,450868,225434,225434,450868,225434,225434
LAB North,Puerto Rico,2025,CSD,Pepsi,Pull-Working,Media Placements,OOH - Out Of Home,50,442733,221366,221367,442733,221366,221367
LAB North,Puerto Rico,2025,CSD,Pepsi,Pull-Working,Media Placements,Other,0,0,0,0,0,0,0
LAB North,Puerto Rico,2025,CSD,Pepsi,Pull-Working,Media Placements,Print,0,0,0,0,0,0,0
LAB North,Puerto Rico,2025,CSD,Pepsi,Pull-Working,Media Placements,Radio,50,45879,22939,22940,45879,22939,22940
LAB North,Puerto Rico,2025,CSD,Pepsi,Pull-Working,Media Placements,TV,50,126958,63479,63479,126958,63479,63479
LAB North,Puerto Rico,2025,CSD,Pepsi,Pull-Working,Sampling,Product Samples,0,0,0,0,0,0,0
LAB North,Puerto Rico,2025,CSD,Pepsi,Pull-Working,Sampling,Sampling Execution,0,0,0,0,0,0,0
LAB North,Puerto Rico,2025,CSD,Pepsi,Pull-Working,Sponsorships,Sponsorships-in game/ in show,50,416984,208492,208492,416984,208492,208492
LAB North,Puerto Rico,2025,CSD,Pepsi,Pull-Working,Sponsorships,Sports-athlete/team contracts,50,306866,153433,153433,306866,153433,153433
LAB North,Puerto Rico,2025,CSD,Pepsi,Pull-Working,Sponsorships,Sports-on field or in show props,0,0,0,0,0,0,0
LAB North,Puerto Rico,2025,CSD,Pepsi,Pull-Working,Sponsorships,Sports-stadium contracts,0,0,0,0,0,0,0